Datum;Uhrzeit;Fahrradbruecke;Fahrradbruecke stadteinwaerts;Fahrradbruecke stadtauswaerts;Symbol Wetter;Temperatur (°C);Gefühlte Temperatur (°C);Regen (mm)
01/01/2019;00:00;61;25;36;Leicht bewölkt;2;2;0
01/01/2019;01:00;100;49;51;Leicht bewölkt;2;2;0
01/01/2019;02:00;143;73;70;Leicht bewölkt;2;2;0
01/01/2019;03:00;98;59;39;Leicht bewölkt;3;3;0
01/01/2019;04:00;68;34;34;Leicht bewölkt;3;2;0
01/01/2019;05:00;38;20;18;Leicht bewölkt;3;2;0
01/01/2019;06:00;26;11;15;Leicht bewölkt;3;2;0
01/01/2019;07:00;18;8;10;Leicht bewölkt;3;2;0
01/01/2019;08:00;26;13;13;Leicht bewölkt;3;2;0
01/01/2019;09:00;25;16;9;Leicht bewölkt;3;2;0
01/01/2019;10:00;47;23;24;Leicht bewölkt;4;2;0
01/01/2019;11:00;40;23;17;Leicht bewölkt;4;3;0
01/01/2019;12:00;88;49;39;Leicht bewölkt;5;3;0
01/01/2019;13:00;84;40;44;Leicht bewölkt;5;3;0
01/01/2019;14:00;81;39;42;Leicht bewölkt;5;3;0
01/01/2019;15:00;118;56;62;Leicht bewölkt;5;3;0
01/01/2019;16:00;110;56;54;Leicht bewölkt;5;3;0
01/01/2019;17:00;108;47;61;Leicht bewölkt;5;2;0
01/01/2019;18:00;72;32;40;Leicht bewölkt;4;1;0
01/01/2019;19:00;47;19;28;Leicht bewölkt;3;1;0
01/01/2019;20:00;56;40;16;Leicht bewölkt;2;1;0
01/01/2019;21:00;32;10;22;Leicht bewölkt;2;0;0
01/01/2019;22:00;40;16;24;Leicht bewölkt;2;0;0
01/01/2019;23:00;35;17;18;Stellenweiser Nieselregen;3;0;0
02/01/2019;00:00;12;3;9;Stellenweiser Nieselregen;3;0;0
02/01/2019;01:00;5;5;0;Stellenweiser Nieselregen;3;0;0
02/01/2019;02:00;2;0;2;Bedeckt;4;0;0
02/01/2019;03:00;0;0;0;Bedeckt;4;0;0
02/01/2019;04:00;3;3;0;Bedeckt;3;-1;0
02/01/2019;05:00;20;8;12;Leichter Eisregen;3;-2;0
02/01/2019;06:00;69;36;33;Leichter Eisregen;2;-2;0
02/01/2019;07:00;126;66;60;Leichter Eisregen;2;-3;0
02/01/2019;08:00;181;106;75;Stellenweise starker Schneefall;2;-3;0
02/01/2019;09:00;220;145;75;Stellenweise starker Schneefall;1;-3;0
02/01/2019;10:00;231;141;90;Stellenweise starker Schneefall;2;-3;0
02/01/2019;11:00;221;125;96;Mäßige bis starke Schneefälle;2;-3;0
02/01/2019;12:00;269;135;134;Mäßige bis starke Schneefälle;2;-2;0
02/01/2019;13:00;263;125;138;Mäßige bis starke Schneefälle;2;-2;0
02/01/2019;14:00;265;141;124;Mäßige bis starke Schneefälle;2;-2;0
02/01/2019;15:00;287;128;159;Mäßige bis starke Schneefälle;3;-2;0
02/01/2019;16:00;320;144;176;Mäßige bis starke Schneefälle;2;-3;0
02/01/2019;17:00;268;118;150;Mäßige bis starke Schneefälle;1;-3;1
02/01/2019;18:00;220;100;120;Mäßige bis starke Schneefälle;0;-4;1
02/01/2019;19:00;169;62;107;Mäßige bis starke Schneefälle;0;-4;0
02/01/2019;20:00;117;56;61;Mäßige bis starke Schneefälle;-1;-3;0
02/01/2019;21:00;76;37;39;Mäßige bis starke Schneefälle;-1;-3;0
02/01/2019;22:00;87;37;50;Mäßige bis starke Schneefälle;-2;-3;0
02/01/2019;23:00;38;12;26;Leichte Schneeschauer;-2;-3;0
03/01/2019;00:00;24;10;14;Leichte Schneeschauer;-2;-4;0
03/01/2019;01:00;17;5;12;Leichte Schneeschauer;-2;-3;0
03/01/2019;02:00;4;2;2;Leicht bewölkt;-2;-3;0
03/01/2019;03:00;7;2;5;Leicht bewölkt;-1;-3;0
03/01/2019;04:00;10;7;3;Leicht bewölkt;-1;-3;0
03/01/2019;05:00;32;17;15;Stellenweiser Schneefall;-1;-2;0
03/01/2019;06:00;73;42;31;Stellenweiser Schneefall;-1;-2;0
03/01/2019;07:00;133;63;70;Stellenweiser Schneefall;-1;-2;0
03/01/2019;08:00;202;109;93;Stellenweise leichter Schneefall;-1;-1;0
03/01/2019;09:00;201;126;75;Stellenweise leichter Schneefall;-1;-1;0
03/01/2019;10:00;196;109;87;Stellenweise leichter Schneefall;0;0;0
03/01/2019;11:00;198;111;87;Stellenweise leichter Schneefall;1;1;0
03/01/2019;12:00;277;133;144;Stellenweise leichter Schneefall;1;1;0
03/01/2019;13:00;247;125;122;Stellenweise leichter Schneefall;1;1;0
03/01/2019;14:00;290;152;138;Stellenweise leichter Schneefall;1;1;0
03/01/2019;15:00;287;151;136;Stellenweise leichter Schneefall;1;1;0
03/01/2019;16:00;363;173;190;Stellenweise leichter Schneefall;1;1;0
03/01/2019;17:00;290;132;158;Bewölkt;1;0;0
03/01/2019;18:00;279;109;170;Bewölkt;1;-1;0
03/01/2019;19:00;219;95;124;Bewölkt;0;-1;0
03/01/2019;20:00;133;50;83;Bedeckt;0;-2;0
03/01/2019;21:00;80;36;44;Bedeckt;0;-2;0
03/01/2019;22:00;84;28;56;Bedeckt;0;-2;0
03/01/2019;23:00;55;21;34;Starker Schneefall;0;-2;0
04/01/2019;00:00;19;10;9;Starker Schneefall;0;-2;0
04/01/2019;01:00;15;3;12;Starker Schneefall;0;-2;0
04/01/2019;02:00;12;7;5;Starker Schneefall;-1;-2;0
04/01/2019;03:00;7;4;3;Starker Schneefall;-1;-2;0
04/01/2019;04:00;7;6;1;Starker Schneefall;-1;-2;0
04/01/2019;05:00;17;7;10;Leichter Schneefall;-1;-2;0
04/01/2019;06:00;51;28;23;Leichter Schneefall;-2;-2;0
04/01/2019;07:00;127;66;61;Leichter Schneefall;-1;-2;0
04/01/2019;08:00;190;113;77;Bewölkt;-1;-1;0
04/01/2019;09:00;186;115;71;Bewölkt;-1;-1;0
04/01/2019;10:00;203;120;83;Bewölkt;0;0;0
04/01/2019;11:00;232;123;109;Leicht bewölkt;1;1;0
04/01/2019;12:00;277;118;159;Leicht bewölkt;2;2;0
04/01/2019;13:00;257;120;137;Leicht bewölkt;2;1;0
04/01/2019;14:00;307;151;156;Bewölkt;2;1;0
04/01/2019;15:00;267;139;128;Bewölkt;2;1;0
04/01/2019;16:00;301;150;151;Bewölkt;2;0;0
04/01/2019;17:00;295;129;166;Bedeckt;1;0;0
04/01/2019;18:00;272;127;145;Bedeckt;1;0;0
04/01/2019;19:00;216;103;113;Bedeckt;1;-1;0
04/01/2019;20:00;141;75;66;Bewölkt;1;-2;0
04/01/2019;21:00;85;44;41;Bewölkt;1;-2;0
04/01/2019;22:00;64;30;34;Bewölkt;1;-2;0
04/01/2019;23:00;75;25;50;Starker Schneefall;1;-3;0
05/01/2019;00:00;59;32;27;Starker Schneefall;1;-3;0
05/01/2019;01:00;32;12;20;Starker Schneefall;1;-3;0
05/01/2019;02:00;22;7;15;Bedeckt;1;-3;0
05/01/2019;03:00;7;1;6;Bedeckt;1;-3;0
05/01/2019;04:00;17;7;10;Bedeckt;1;-3;0
05/01/2019;05:00;23;15;8;Stellenweise mäßiger Schneefall;1;-3;0
05/01/2019;06:00;18;9;9;Stellenweise mäßiger Schneefall;1;-3;0
05/01/2019;07:00;29;18;11;Stellenweise mäßiger Schneefall;1;-3;0
05/01/2019;08:00;66;38;28;Bedeckt;1;-3;0
05/01/2019;09:00;107;71;36;Bedeckt;1;-4;0
05/01/2019;10:00;114;71;43;Bedeckt;1;-4;0
05/01/2019;11:00;104;53;51;Starker Schneefall;1;-4;0
05/01/2019;12:00;131;73;58;Starker Schneefall;1;-4;0
05/01/2019;13:00;100;42;58;Starker Schneefall;1;-4;0
05/01/2019;14:00;118;53;65;Bedeckt;1;-4;1
05/01/2019;15:00;110;63;47;Bedeckt;2;-3;1
05/01/2019;16:00;102;40;62;Bedeckt;1;-3;1
05/01/2019;17:00;112;58;54;Starker Schneefall;1;-2;2
05/01/2019;18:00;131;59;72;Starker Schneefall;1;-1;2
05/01/2019;19:00;107;49;58;Starker Schneefall;0;-1;2
05/01/2019;20:00;99;33;66;Mäßiger bis starker Eisregen;-1;-2;2
05/01/2019;21:00;84;46;38;Mäßiger bis starker Eisregen;-2;-2;2
05/01/2019;22:00;69;35;34;Mäßiger bis starker Eisregen;-1;-2;2
05/01/2019;23:00;76;40;36;Mäßiger Regenfall;0;-2;2
06/01/2019;00:00;63;34;29;Mäßiger Regenfall;1;-2;2
06/01/2019;01:00;31;16;15;Mäßiger Regenfall;1;-2;2
06/01/2019;02:00;25;7;18;Starker Regenfall;2;-2;2
06/01/2019;03:00;33;7;26;Starker Regenfall;2;-2;2
06/01/2019;04:00;10;4;6;Starker Regenfall;2;-2;1
06/01/2019;05:00;12;5;7;Starker Schneefall;2;-2;1
06/01/2019;06:00;7;3;4;Starker Schneefall;2;-2;0
06/01/2019;07:00;11;5;6;Starker Schneefall;2;-2;0
06/01/2019;08:00;22;11;11;Bedeckt;2;-2;0
06/01/2019;09:00;61;32;29;Bedeckt;2;-2;1
06/01/2019;10:00;62;30;32;Bedeckt;2;-2;1
06/01/2019;11:00;88;37;51;Starker Schneefall;2;-1;1
06/01/2019;12:00;115;61;54;Starker Schneefall;2;-1;1
06/01/2019;13:00;92;52;40;Starker Schneefall;2;-1;0
06/01/2019;14:00;120;62;58;Starker Schneefall;2;-1;0
06/01/2019;15:00;142;70;72;Starker Schneefall;3;-1;0
06/01/2019;16:00;135;56;79;Starker Schneefall;2;-1;0
06/01/2019;17:00;165;70;95;Leichter Eisregen;2;0;0
06/01/2019;18:00;140;63;77;Leichter Eisregen;2;0;0
06/01/2019;19:00;132;73;59;Leichter Eisregen;2;0;0
06/01/2019;20:00;102;41;61;Leichter Eisregen;2;0;0
06/01/2019;21:00;58;31;27;Leichter Eisregen;2;0;0
06/01/2019;22:00;51;29;22;Leichter Eisregen;2;0;0
06/01/2019;23:00;36;20;16;Leichter Eisregen;2;0;0
07/01/2019;00:00;31;19;12;Leichter Eisregen;2;0;0
07/01/2019;01:00;5;5;0;Leichter Eisregen;2;0;0
07/01/2019;02:00;6;4;2;Leichter Eisregen;2;0;0
07/01/2019;03:00;5;4;1;Leichter Eisregen;2;0;0
07/01/2019;04:00;9;6;3;Leichter Eisregen;2;0;0
07/01/2019;05:00;40;31;9;Starker Schneefall;2;0;0
07/01/2019;06:00;114;73;41;Starker Schneefall;2;0;0
07/01/2019;07:00;710;439;271;Starker Schneefall;2;1;0
07/01/2019;08:00;522;289;233;Leichter Nebel;2;1;0
07/01/2019;09:00;459;310;149;Leichter Nebel;2;2;0
07/01/2019;10:00;234;125;109;Leichter Nebel;2;2;0
07/01/2019;11:00;333;146;187;Mäßiger Schneefall;3;3;0
07/01/2019;12:00;388;184;204;Mäßiger Schneefall;3;3;0
07/01/2019;13:00;576;241;335;Mäßiger Schneefall;3;3;0
07/01/2019;14:00;352;172;180;Bewölkt;3;3;0
07/01/2019;15:00;675;299;376;Bewölkt;3;3;0
07/01/2019;16:00;542;241;301;Bewölkt;3;2;0
07/01/2019;17:00;700;300;400;Bewölkt;2;2;0
07/01/2019;18:00;546;245;301;Bewölkt;2;1;0
07/01/2019;19:00;419;164;255;Bewölkt;1;0;0
07/01/2019;20:00;247;113;134;Leicht bewölkt;1;0;0
07/01/2019;21:00;164;80;84;Leicht bewölkt;1;-1;0
07/01/2019;22:00;149;52;97;Leicht bewölkt;1;-1;0
07/01/2019;23:00;61;26;35;Leicht bewölkt;1;-1;0
08/01/2019;00:00;25;14;11;Leicht bewölkt;2;-2;0
08/01/2019;01:00;15;7;8;Leicht bewölkt;2;-2;0
08/01/2019;02:00;9;5;4;Bedeckt;2;-2;0
08/01/2019;03:00;4;4;0;Bedeckt;2;-3;0
08/01/2019;04:00;8;5;3;Bedeckt;2;-3;0
08/01/2019;05:00;33;22;11;Starker Schneefall;2;-3;0
08/01/2019;06:00;110;79;31;Starker Schneefall;3;-2;0
08/01/2019;07:00;712;445;267;Starker Schneefall;3;-2;0
08/01/2019;08:00;559;317;242;Bedeckt;3;-2;0
08/01/2019;09:00;529;347;182;Bedeckt;4;-1;0
08/01/2019;10:00;269;150;119;Bedeckt;4;-1;0
08/01/2019;11:00;402;190;212;Leichter Regenfall;5;-1;0
08/01/2019;12:00;389;151;238;Leichter Regenfall;5;0;0
08/01/2019;13:00;567;215;352;Leichter Regenfall;5;0;0
08/01/2019;14:00;331;174;157;Bedeckt;5;0;0
08/01/2019;15:00;673;312;361;Bedeckt;5;0;0
08/01/2019;16:00;583;268;315;Bedeckt;5;0;0
08/01/2019;17:00;730;324;406;Leichter Regenschauer;4;-1;0
08/01/2019;18:00;531;221;310;Leichter Regenschauer;4;-1;0
08/01/2019;19:00;435;196;239;Leichter Regenschauer;4;-1;0
08/01/2019;20:00;259;106;153;Bedeckt;4;-2;0
08/01/2019;21:00;158;54;104;Bedeckt;4;-2;0
08/01/2019;22:00;163;56;107;Bedeckt;3;-2;0
08/01/2019;23:00;67;34;33;Leichter Eisregen;3;-2;0
09/01/2019;00:00;34;21;13;Leichter Eisregen;3;-2;0
09/01/2019;01:00;12;6;6;Leichter Eisregen;3;-3;0
09/01/2019;02:00;11;7;4;Mäßige bis starke Schneefälle;3;-3;0
09/01/2019;03:00;3;3;0;Mäßige bis starke Schneefälle;2;-3;0
09/01/2019;04:00;9;6;3;Mäßige bis starke Schneefälle;2;-4;1
09/01/2019;05:00;29;17;12;Schneesturm;2;-4;1
09/01/2019;06:00;109;64;45;Schneesturm;2;-4;1
09/01/2019;07:00;806;506;300;Schneesturm;2;-4;1
09/01/2019;08:00;559;322;237;Schneesturm;2;-4;1
09/01/2019;09:00;524;327;197;Schneesturm;1;-3;1
09/01/2019;10:00;276;136;140;Schneesturm;1;-3;0
09/01/2019;11:00;413;196;217;Starker Schneefall;1;-3;0
09/01/2019;12:00;402;200;202;Starker Schneefall;2;-3;0
09/01/2019;13:00;670;318;352;Starker Schneefall;1;-3;0
09/01/2019;14:00;391;194;197;Mäßige bis starke Schneefälle;1;-3;0
09/01/2019;15:00;528;226;302;Mäßige bis starke Schneefälle;1;-3;0
09/01/2019;16:00;534;244;290;Mäßige bis starke Schneefälle;1;-4;0
09/01/2019;17:00;658;268;390;Starker Schneefall;0;-4;0
09/01/2019;18:00;570;250;320;Starker Schneefall;0;-4;0
09/01/2019;19:00;447;194;253;Starker Schneefall;-1;-4;0
09/01/2019;20:00;287;142;145;Mäßige bis starke Schneefälle;-1;-4;0
09/01/2019;21:00;178;78;100;Mäßige bis starke Schneefälle;-1;-4;0
09/01/2019;22:00;209;95;114;Mäßige bis starke Schneefälle;-1;-4;0
09/01/2019;23:00;83;33;50;Starker Schneefall;-1;-4;0
10/01/2019;00:00;48;16;32;Starker Schneefall;-1;-4;0
10/01/2019;01:00;25;9;16;Starker Schneefall;-1;-4;0
10/01/2019;02:00;14;5;9;Starker Schneefall;-1;-4;0
10/01/2019;03:00;3;3;0;Starker Schneefall;-1;-4;0
10/01/2019;04:00;7;5;2;Starker Schneefall;-1;-4;0
10/01/2019;05:00;32;20;12;Starker Schneefall;-1;-4;1
10/01/2019;06:00;97;63;34;Starker Schneefall;-1;-4;1
10/01/2019;07:00;530;311;219;Starker Schneefall;-1;-4;1
10/01/2019;08:00;340;209;131;Starker Schneefall;-1;-3;1
10/01/2019;09:00;335;231;104;Starker Schneefall;-1;-3;1
10/01/2019;10:00;143;94;49;Starker Schneefall;0;-3;1
10/01/2019;11:00;218;112;106;Starker Schneefall;0;-3;1
10/01/2019;12:00;178;67;111;Starker Schneefall;0;-3;1
10/01/2019;13:00;398;163;235;Starker Schneefall;0;-3;1
10/01/2019;14:00;261;139;122;Starker Schneefall;0;-3;1
10/01/2019;15:00;421;195;226;Starker Schneefall;1;-3;1
10/01/2019;16:00;364;180;184;Starker Schneefall;0;-3;0
10/01/2019;17:00;450;204;246;Starker Schneefall;0;-4;0
10/01/2019;18:00;379;181;198;Starker Schneefall;0;-4;0
10/01/2019;19:00;303;134;169;Starker Schneefall;-1;-5;0
10/01/2019;20:00;222;94;128;Starker Schneefall;-1;-5;0
10/01/2019;21:00;150;71;79;Starker Schneefall;-2;-6;0
10/01/2019;22:00;147;47;100;Starker Schneefall;-3;-7;0
10/01/2019;23:00;77;37;40;Mäßiger Schneefall;-4;-7;0
11/01/2019;00:00;36;20;16;Mäßiger Schneefall;-4;-8;0
11/01/2019;01:00;14;7;7;Mäßiger Schneefall;-5;-8;0
11/01/2019;02:00;11;7;4;Mäßiger Schneefall;-5;-8;0
11/01/2019;03:00;2;1;1;Mäßiger Schneefall;-6;-9;0
11/01/2019;04:00;9;6;3;Mäßiger Schneefall;-6;-8;0
11/01/2019;05:00;24;18;6;Leicht bewölkt;-7;-8;0
11/01/2019;06:00;105;61;44;Leicht bewölkt;-7;-8;0
11/01/2019;07:00;576;337;239;Leicht bewölkt;-6;-7;0
11/01/2019;08:00;441;250;191;Leicht bewölkt;-5;-6;0
11/01/2019;09:00;453;293;160;Leicht bewölkt;-5;-6;0
11/01/2019;10:00;279;140;139;Leicht bewölkt;-4;-5;0
11/01/2019;11:00;330;174;156;Leicht bewölkt;-3;-5;0
11/01/2019;12:00;450;198;252;Leicht bewölkt;-2;-4;0
11/01/2019;13:00;603;258;345;Leicht bewölkt;-2;-4;0
11/01/2019;14:00;401;211;190;Bedeckt;-1;-4;0
11/01/2019;15:00;412;189;223;Bedeckt;-1;-4;0
11/01/2019;16:00;450;202;248;Bedeckt;-1;-5;0
11/01/2019;17:00;438;199;239;Mäßiger Schneefall;-1;-5;0
11/01/2019;18:00;372;171;201;Mäßiger Schneefall;-1;-5;0
11/01/2019;19:00;301;150;151;Mäßiger Schneefall;-2;-5;0
11/01/2019;20:00;180;86;94;Bedeckt;-3;-5;0
11/01/2019;21:00;123;47;76;Bedeckt;-4;-6;0
11/01/2019;22:00;125;43;82;Bedeckt;-3;-5;0
11/01/2019;23:00;99;39;60;Starker Schneefall;-3;-5;1
12/01/2019;00:00;87;29;58;Starker Schneefall;-2;-4;1
12/01/2019;01:00;46;22;24;Starker Schneefall;-1;-4;1
12/01/2019;02:00;34;22;12;Starker Schneefall;0;-4;0
12/01/2019;03:00;17;9;8;Starker Schneefall;0;-3;0
12/01/2019;04:00;15;7;8;Starker Schneefall;0;-3;0
12/01/2019;05:00;26;21;5;Starker Schneefall;1;-3;0
12/01/2019;06:00;30;15;15;Starker Schneefall;1;-3;0
12/01/2019;07:00;40;25;15;Starker Schneefall;1;-3;0
12/01/2019;08:00;122;78;44;Bedeckt;1;-2;0
12/01/2019;09:00;157;103;54;Bedeckt;1;-2;0
12/01/2019;10:00;189;118;71;Bedeckt;2;-2;0
12/01/2019;11:00;245;132;113;Starker Schneefall;2;-2;0
12/01/2019;12:00;270;158;112;Starker Schneefall;2;-1;0
12/01/2019;13:00;262;129;133;Starker Schneefall;2;-1;0
12/01/2019;14:00;251;133;118;Bedeckt;3;-1;0
12/01/2019;15:00;251;106;145;Bedeckt;3;-1;0
12/01/2019;16:00;243;96;147;Bedeckt;3;-1;0
12/01/2019;17:00;255;125;130;Bedeckt;3;-1;0
12/01/2019;18:00;263;118;145;Bedeckt;3;-2;0
12/01/2019;19:00;191;100;91;Bedeckt;2;-2;0
12/01/2019;20:00;201;104;97;Bedeckt;1;-2;1
12/01/2019;21:00;113;66;47;Bedeckt;0;-2;1
12/01/2019;22:00;129;47;82;Bedeckt;1;-2;1
12/01/2019;23:00;125;43;82;Mäßiger bis starker Eisregen;1;-2;1
13/01/2019;00:00;110;30;80;Mäßiger bis starker Eisregen;2;-2;1
13/01/2019;01:00;59;20;39;Mäßiger bis starker Eisregen;2;-2;1
13/01/2019;02:00;47;15;32;Mäßiger bis starker Eisregen;3;-2;1
13/01/2019;03:00;28;8;20;Mäßiger bis starker Eisregen;3;-2;1
13/01/2019;04:00;28;16;12;Mäßiger bis starker Eisregen;3;-2;1
13/01/2019;05:00;15;5;10;Leichter Regenfall;3;-2;1
13/01/2019;06:00;7;6;1;Leichter Regenfall;3;-2;0
13/01/2019;07:00;18;9;9;Leichter Regenfall;3;-2;0
13/01/2019;08:00;47;27;20;Leichter Regenfall;4;-1;0
13/01/2019;09:00;79;48;31;Leichter Regenfall;4;-1;1
13/01/2019;10:00;79;41;38;Leichter Regenfall;4;-1;1
13/01/2019;11:00;92;46;46;Leichter Regenfall;4;-1;1
13/01/2019;12:00;79;53;26;Leichter Regenfall;4;-1;1
13/01/2019;13:00;95;49;46;Leichter Regenfall;4;-1;1
13/01/2019;14:00;110;61;49;Mäßiger Regenfall;4;-1;2
13/01/2019;15:00;87;57;30;Mäßiger Regenfall;5;-1;2
13/01/2019;16:00;151;75;76;Mäßiger Regenfall;4;0;2
13/01/2019;17:00;128;53;75;Mäßiger Regenfall;3;0;2
13/01/2019;18:00;138;65;73;Mäßiger Regenfall;3;1;2
13/01/2019;19:00;95;47;48;Mäßiger Regenfall;2;1;2
13/01/2019;20:00;99;49;50;Mäßiger Regenfall;1;1;1
13/01/2019;21:00;68;30;38;Mäßiger Regenfall;1;1;1
13/01/2019;22:00;59;27;32;Mäßiger Regenfall;2;1;1
13/01/2019;23:00;33;15;18;Leichter Regenfall;3;1;0
14/01/2019;00:00;11;4;7;Leichter Regenfall;4;1;0
14/01/2019;01:00;16;8;8;Leichter Regenfall;5;1;0
14/01/2019;02:00;6;4;2;Bedeckt;5;1;0
14/01/2019;03:00;1;1;0;Bedeckt;6;1;0
14/01/2019;04:00;4;3;1;Bedeckt;5;1;1
14/01/2019;05:00;27;17;10;Leichter Regenfall;5;1;1
14/01/2019;06:00;115;61;54;Leichter Regenfall;4;0;1
14/01/2019;07:00;688;411;277;Leichter Regenfall;4;0;1
14/01/2019;08:00;512;277;235;Leichter Regenfall;4;0;1
14/01/2019;09:00;478;307;171;Leichter Regenfall;4;0;0
14/01/2019;10:00;301;166;135;Leichter Regenfall;4;0;0
14/01/2019;11:00;380;180;200;Leichter Regenfall;5;0;0
14/01/2019;12:00;382;187;195;Leichter Regenfall;5;1;0
14/01/2019;13:00;551;225;326;Leichter Regenfall;5;0;0
14/01/2019;14:00;352;195;157;Bedeckt;5;0;0
14/01/2019;15:00;627;295;332;Bedeckt;5;0;0
14/01/2019;16:00;511;229;282;Bedeckt;4;0;0
14/01/2019;17:00;697;321;376;Leichter Regenfall;4;-1;1
14/01/2019;18:00;562;268;294;Leichter Regenfall;4;-1;1
14/01/2019;19:00;486;213;273;Leichter Regenfall;3;-1;1
14/01/2019;20:00;268;121;147;Leichte Eisregen;2;-1;0
14/01/2019;21:00;202;78;124;Leichte Eisregen;2;-2;0
14/01/2019;22:00;157;57;100;Leichte Eisregen;1;-2;0
14/01/2019;23:00;77;28;49;Mäßige bis starke Schneefälle;1;-2;0
15/01/2019;00:00;33;10;23;Mäßige bis starke Schneefälle;1;-2;0
15/01/2019;01:00;17;6;11;Mäßige bis starke Schneefälle;1;-2;0
15/01/2019;02:00;5;5;0;Leicht bewölkt;1;-2;0
15/01/2019;03:00;3;1;2;Leicht bewölkt;1;-2;0
15/01/2019;04:00;6;4;2;Leicht bewölkt;1;-2;0
15/01/2019;05:00;26;16;10;Mäßige bis starke Schneefälle;1;-2;0
15/01/2019;06:00;124;75;49;Mäßige bis starke Schneefälle;1;-2;0
15/01/2019;07:00;725;463;262;Mäßige bis starke Schneefälle;1;-2;0
15/01/2019;08:00;633;359;274;Leicht bewölkt;1;-1;0
15/01/2019;09:00;562;347;215;Leicht bewölkt;2;-1;0
15/01/2019;10:00;323;166;157;Leicht bewölkt;2;0;0
15/01/2019;11:00;473;245;228;Stellenweise leichter Schneefall;3;0;0
15/01/2019;12:00;448;176;272;Stellenweise leichter Schneefall;4;1;0
15/01/2019;13:00;610;242;368;Stellenweise leichter Schneefall;4;1;0
15/01/2019;14:00;426;209;217;Leicht bewölkt;4;1;0
15/01/2019;15:00;694;326;368;Leicht bewölkt;4;2;0
15/01/2019;16:00;638;275;363;Leicht bewölkt;4;1;0
15/01/2019;17:00;783;359;424;Leicht bewölkt;3;1;0
15/01/2019;18:00;653;295;358;Leicht bewölkt;2;1;0
15/01/2019;19:00;531;227;304;Leicht bewölkt;2;0;0
15/01/2019;20:00;318;141;177;Leicht bewölkt;2;0;0
15/01/2019;21:00;228;79;149;Leicht bewölkt;1;-1;0
15/01/2019;22:00;190;71;119;Leicht bewölkt;1;0;0
15/01/2019;23:00;85;31;54;Leicht bewölkt;1;0;0
16/01/2019;00:00;32;11;21;Leicht bewölkt;1;0;0
16/01/2019;01:00;22;9;13;Leicht bewölkt;1;0;0
16/01/2019;02:00;4;3;1;Leicht bewölkt;0;0;0
16/01/2019;03:00;4;3;1;Leicht bewölkt;0;0;0
16/01/2019;04:00;11;10;1;Leicht bewölkt;-1;-1;0
16/01/2019;05:00;33;20;13;Leicht bewölkt;-1;-1;0
16/01/2019;06:00;132;79;53;Leicht bewölkt;-2;-2;0
16/01/2019;07:00;839;522;317;Leicht bewölkt;-1;-1;0
16/01/2019;08:00;615;359;256;Leicht bewölkt;0;0;0
16/01/2019;09:00;515;319;196;Leicht bewölkt;1;1;0
16/01/2019;10:00;253;128;125;Leicht bewölkt;2;2;0
16/01/2019;11:00;381;175;206;Leicht bewölkt;3;3;0
16/01/2019;12:00;452;195;257;Leicht bewölkt;5;5;0
16/01/2019;13:00;680;311;369;Leicht bewölkt;5;5;0
16/01/2019;14:00;475;229;246;Leicht bewölkt;5;5;0
16/01/2019;15:00;601;264;337;Leicht bewölkt;6;5;0
16/01/2019;16:00;564;244;320;Leicht bewölkt;5;4;0
16/01/2019;17:00;795;346;449;Bewölkt;4;3;0
16/01/2019;18:00;597;253;344;Bewölkt;4;2;0
16/01/2019;19:00;503;190;313;Bewölkt;3;1;0
16/01/2019;20:00;385;182;203;Leicht bewölkt;3;0;0
16/01/2019;21:00;258;114;144;Leicht bewölkt;2;-1;0
16/01/2019;22:00;191;73;118;Leicht bewölkt;2;-1;0
16/01/2019;23:00;124;59;65;Leicht bewölkt;2;-1;0
17/01/2019;00:00;82;27;55;Leicht bewölkt;2;-2;0
17/01/2019;01:00;45;6;39;Leicht bewölkt;2;-1;0
17/01/2019;02:00;15;13;2;Leicht bewölkt;2;-1;0
17/01/2019;03:00;5;5;0;Leicht bewölkt;2;-1;0
17/01/2019;04:00;7;6;1;Leicht bewölkt;3;-1;0
17/01/2019;05:00;33;23;10;Leicht bewölkt;3;-1;0
17/01/2019;06:00;124;74;50;Leicht bewölkt;3;-1;0
17/01/2019;07:00;741;454;287;Leicht bewölkt;3;0;0
17/01/2019;08:00;531;303;228;Leicht bewölkt;3;1;0
17/01/2019;09:00;521;350;171;Leicht bewölkt;4;1;0
17/01/2019;10:00;277;160;117;Leicht bewölkt;4;2;0
17/01/2019;11:00;379;179;200;Leicht bewölkt;5;2;0
17/01/2019;12:00;372;144;228;Leicht bewölkt;6;3;0
17/01/2019;13:00;488;213;275;Leicht bewölkt;5;2;0
17/01/2019;14:00;334;160;174;Bewölkt;5;2;0
17/01/2019;15:00;638;282;356;Bewölkt;5;1;0
17/01/2019;16:00;558;273;285;Bewölkt;5;1;0
17/01/2019;17:00;694;312;382;Stellenweiser leichter Regenfall;4;0;0
17/01/2019;18:00;588;261;327;Stellenweiser leichter Regenfall;4;-1;0
17/01/2019;19:00;440;187;253;Stellenweiser leichter Regenfall;4;-1;0
17/01/2019;20:00;256;101;155;Leichter Eisregen;3;-1;0
17/01/2019;21:00;198;97;101;Leichter Eisregen;3;-2;0
17/01/2019;22:00;185;72;113;Leichter Eisregen;2;-2;0
17/01/2019;23:00;104;43;61;Mäßige bis starke Schneefälle;2;-2;0
18/01/2019;00:00;59;27;32;Mäßige bis starke Schneefälle;2;-3;0
18/01/2019;01:00;28;6;22;Mäßige bis starke Schneefälle;1;-3;0
18/01/2019;02:00;4;4;0;Mäßige bis starke Schneefälle;1;-3;0
18/01/2019;03:00;4;3;1;Mäßige bis starke Schneefälle;1;-3;0
18/01/2019;04:00;10;4;6;Mäßige bis starke Schneefälle;0;-3;0
18/01/2019;05:00;35;23;12;Stellenweise starker Schneefall;-1;-3;0
18/01/2019;06:00;89;43;46;Stellenweise starker Schneefall;-2;-3;0
18/01/2019;07:00;515;304;211;Stellenweise starker Schneefall;-2;-2;0
18/01/2019;08:00;462;265;197;Stellenweise starker Schneefall;-1;-2;0
18/01/2019;09:00;426;269;157;Stellenweise starker Schneefall;-1;-1;0
18/01/2019;10:00;250;156;94;Stellenweise starker Schneefall;-1;-1;0
18/01/2019;11:00;321;176;145;Leicht bewölkt;0;-1;0
18/01/2019;12:00;379;176;203;Leicht bewölkt;1;-1;0
18/01/2019;13:00;503;210;293;Leicht bewölkt;1;-1;0
18/01/2019;14:00;350;168;182;Leicht bewölkt;1;-2;0
18/01/2019;15:00;400;196;204;Leicht bewölkt;1;-2;0
18/01/2019;16:00;480;234;246;Leicht bewölkt;0;-3;0
18/01/2019;17:00;490;233;257;Leicht bewölkt;-1;-4;0
18/01/2019;18:00;401;180;221;Leicht bewölkt;-2;-6;0
18/01/2019;19:00;316;136;180;Leicht bewölkt;-3;-6;0
18/01/2019;20:00;242;124;118;Leicht bewölkt;-3;-7;0
18/01/2019;21:00;165;65;100;Leicht bewölkt;-4;-7;0
18/01/2019;22:00;138;73;65;Leicht bewölkt;-4;-7;0
18/01/2019;23:00;146;60;86;Leicht bewölkt;-5;-7;0
19/01/2019;00:00;68;29;39;Leicht bewölkt;-5;-8;0
19/01/2019;01:00;62;25;37;Leicht bewölkt;-5;-8;0
19/01/2019;02:00;46;21;25;Leicht bewölkt;-5;-8;0
19/01/2019;03:00;31;17;14;Leicht bewölkt;-6;-8;0
19/01/2019;04:00;13;3;10;Leicht bewölkt;-6;-7;0
19/01/2019;05:00;17;10;7;Leicht bewölkt;-6;-7;0
19/01/2019;06:00;29;19;10;Leicht bewölkt;-6;-7;0
19/01/2019;07:00;41;25;16;Leicht bewölkt;-5;-6;0
19/01/2019;08:00;113;69;44;Leicht bewölkt;-5;-5;0
19/01/2019;09:00;234;139;95;Leicht bewölkt;-4;-4;0
19/01/2019;10:00;258;163;95;Leicht bewölkt;-3;-3;0
19/01/2019;11:00;280;153;127;Leicht bewölkt;-1;-2;0
19/01/2019;12:00;282;151;131;Leicht bewölkt;0;-1;0
19/01/2019;13:00;310;159;151;Leicht bewölkt;0;-1;0
19/01/2019;14:00;303;129;174;Leicht bewölkt;1;-1;0
19/01/2019;15:00;274;132;142;Leicht bewölkt;1;0;0
19/01/2019;16:00;239;105;134;Leicht bewölkt;0;-1;0
19/01/2019;17:00;281;121;160;Leicht bewölkt;-1;-2;0
19/01/2019;18:00;267;135;132;Leicht bewölkt;-2;-3;0
19/01/2019;19:00;190;85;105;Leicht bewölkt;-2;-3;0
19/01/2019;20:00;165;76;89;Leicht bewölkt;-2;-3;0
19/01/2019;21:00;139;75;64;Leicht bewölkt;-3;-3;0
19/01/2019;22:00;113;53;60;Leicht bewölkt;-3;-3;0
19/01/2019;23:00;125;51;74;Leicht bewölkt;-3;-3;0
20/01/2019;00:00;97;43;54;Leicht bewölkt;-3;-3;0
20/01/2019;01:00;50;15;35;Leicht bewölkt;-3;-3;0
20/01/2019;02:00;59;17;42;Leicht bewölkt;-3;-3;0
20/01/2019;03:00;30;14;16;Leicht bewölkt;-3;-3;0
20/01/2019;04:00;44;21;23;Leicht bewölkt;-3;-3;0
20/01/2019;05:00;16;8;8;Leicht bewölkt;-3;-3;0
20/01/2019;06:00;25;13;12;Leicht bewölkt;-3;-3;0
20/01/2019;07:00;22;8;14;Leicht bewölkt;-2;-2;0
20/01/2019;08:00;35;14;21;Leicht bewölkt;-2;-2;0
20/01/2019;09:00;121;69;52;Leicht bewölkt;-1;-1;0
20/01/2019;10:00;113;67;46;Leicht bewölkt;0;0;0
20/01/2019;11:00;136;68;68;Leicht bewölkt;1;1;0
20/01/2019;12:00;172;83;89;Leicht bewölkt;3;2;0
20/01/2019;13:00;173;88;85;Leicht bewölkt;3;3;0
20/01/2019;14:00;195;102;93;Bewölkt;3;3;0
20/01/2019;15:00;183;89;94;Bewölkt;3;3;0
20/01/2019;16:00;191;80;111;Bewölkt;2;2;0
20/01/2019;17:00;201;105;96;Leichter Schneefall;1;1;0
20/01/2019;18:00;172;64;108;Leichter Schneefall;0;0;0
20/01/2019;19:00;154;80;74;Leichter Schneefall;0;-1;0
20/01/2019;20:00;150;67;83;Leichter Schneefall;-1;-2;0
20/01/2019;21:00;89;45;44;Leichter Schneefall;-1;-3;0
20/01/2019;22:00;70;23;47;Leichter Schneefall;-2;-3;0
20/01/2019;23:00;47;23;24;Leicht bewölkt;-2;-3;0
21/01/2019;00:00;15;8;7;Leicht bewölkt;-2;-3;0
21/01/2019;01:00;12;5;7;Leicht bewölkt;-2;-4;0
21/01/2019;02:00;4;4;0;Stellenweise leichter Schneefall;-3;-4;0
21/01/2019;03:00;0;0;0;Stellenweise leichter Schneefall;-3;-5;0
21/01/2019;04:00;8;7;1;Stellenweise leichter Schneefall;-4;-5;0
21/01/2019;05:00;23;13;10;Leicht bewölkt;-4;-6;0
21/01/2019;06:00;117;79;38;Leicht bewölkt;-4;-7;0
21/01/2019;07:00;722;446;276;Leicht bewölkt;-4;-6;0
21/01/2019;08:00;542;301;241;Bewölkt;-3;-5;0
21/01/2019;09:00;493;327;166;Bewölkt;-3;-5;0
21/01/2019;10:00;270;149;121;Bewölkt;-2;-4;0
21/01/2019;11:00;367;188;179;Bewölkt;-1;-3;0
21/01/2019;12:00;444;182;262;Bewölkt;0;-2;0
21/01/2019;13:00;601;273;328;Bewölkt;0;-1;0
21/01/2019;14:00;386;194;192;Bewölkt;0;-1;0
21/01/2019;15:00;620;284;336;Bewölkt;1;-1;0
21/01/2019;16:00;541;255;286;Bewölkt;0;-1;0
21/01/2019;17:00;695;315;380;Bewölkt;-1;-2;0
21/01/2019;18:00;553;266;287;Bewölkt;-2;-3;0
21/01/2019;19:00;493;219;274;Bewölkt;-2;-3;0
21/01/2019;20:00;273;120;153;Bedeckt;-3;-3;0
21/01/2019;21:00;200;86;114;Bedeckt;-3;-4;0
21/01/2019;22:00;158;52;106;Bedeckt;-3;-4;0
21/01/2019;23:00;73;23;50;Bewölkt;-4;-4;0
22/01/2019;00:00;34;13;21;Bewölkt;-4;-4;0
22/01/2019;01:00;17;5;12;Bewölkt;-4;-4;0
22/01/2019;02:00;3;3;0;Bewölkt;-4;-4;0
22/01/2019;03:00;4;3;1;Bewölkt;-4;-4;0
22/01/2019;04:00;5;5;0;Bewölkt;-4;-4;0
22/01/2019;05:00;32;22;10;Leicht bewölkt;-4;-4;0
22/01/2019;06:00;141;84;57;Leicht bewölkt;-4;-4;0
22/01/2019;07:00;766;502;264;Leicht bewölkt;-4;-4;0
22/01/2019;08:00;578;319;259;Leicht bewölkt;-3;-3;0
22/01/2019;09:00;585;375;210;Leicht bewölkt;-3;-3;0
22/01/2019;10:00;293;168;125;Leicht bewölkt;-2;-2;0
22/01/2019;11:00;413;191;222;Leicht bewölkt;-1;-1;0
22/01/2019;12:00;392;161;231;Leicht bewölkt;1;1;0
22/01/2019;13:00;584;240;344;Leicht bewölkt;1;1;0
22/01/2019;14:00;397;197;200;Leicht bewölkt;2;1;0
22/01/2019;15:00;632;301;331;Leicht bewölkt;2;2;0
22/01/2019;16:00;550;279;271;Leicht bewölkt;1;1;0
22/01/2019;17:00;707;311;396;Leicht bewölkt;0;0;0
22/01/2019;18:00;579;258;321;Leicht bewölkt;-1;-2;0
22/01/2019;19:00;440;193;247;Leicht bewölkt;-1;-2;0
22/01/2019;20:00;292;140;152;Leicht bewölkt;-2;-3;0
22/01/2019;21:00;210;85;125;Leicht bewölkt;-3;-3;0
22/01/2019;22:00;187;77;110;Leicht bewölkt;-3;-4;0
22/01/2019;23:00;71;22;49;Leicht bewölkt;-4;-5;0
23/01/2019;00:00;41;14;27;Leicht bewölkt;-4;-6;0
23/01/2019;01:00;13;7;6;Leicht bewölkt;-4;-6;0
23/01/2019;02:00;5;2;3;Leicht bewölkt;-4;-6;0
23/01/2019;03:00;3;2;1;Leicht bewölkt;-5;-6;0
23/01/2019;04:00;6;4;2;Leicht bewölkt;-5;-6;0
23/01/2019;05:00;34;20;14;Leicht bewölkt;-5;-6;0
23/01/2019;06:00;123;69;54;Leicht bewölkt;-5;-6;0
23/01/2019;07:00;821;513;308;Leicht bewölkt;-5;-5;0
23/01/2019;08:00;551;322;229;Leicht bewölkt;-4;-4;0
23/01/2019;09:00;515;323;192;Leicht bewölkt;-4;-4;0
23/01/2019;10:00;244;137;107;Leicht bewölkt;-3;-3;0
23/01/2019;11:00;368;184;184;Bewölkt;-2;-2;0
23/01/2019;12:00;484;208;276;Bewölkt;0;-2;0
23/01/2019;13:00;642;315;327;Bewölkt;0;-2;0
23/01/2019;14:00;371;179;192;Leicht bewölkt;0;-2;0
23/01/2019;15:00;595;266;329;Leicht bewölkt;0;-2;0
23/01/2019;16:00;495;236;259;Leicht bewölkt;-1;-3;0
23/01/2019;17:00;726;286;440;Leicht bewölkt;-2;-4;0
23/01/2019;18:00;534;219;315;Leicht bewölkt;-3;-5;0
23/01/2019;19:00;463;213;250;Leicht bewölkt;-4;-6;0
23/01/2019;20:00;322;176;146;Leicht bewölkt;-4;-6;0
23/01/2019;21:00;204;89;115;Leicht bewölkt;-5;-7;0
23/01/2019;22:00;199;75;124;Leicht bewölkt;-5;-7;0
23/01/2019;23:00;117;47;70;Bewölkt;-6;-6;0
24/01/2019;00:00;60;19;41;Bewölkt;-6;-6;0
24/01/2019;01:00;22;6;16;Bewölkt;-6;-6;0
24/01/2019;02:00;14;5;9;Leicht bewölkt;-6;-6;0
24/01/2019;03:00;7;4;3;Leicht bewölkt;-6;-6;0
24/01/2019;04:00;9;8;1;Leicht bewölkt;-6;-6;0
24/01/2019;05:00;24;15;9;Bewölkt;-6;-6;0
24/01/2019;06:00;125;81;44;Bewölkt;-6;-6;0
24/01/2019;07:00;746;458;288;Bewölkt;-6;-6;0
24/01/2019;08:00;538;307;231;Bedeckt;-5;-5;0
24/01/2019;09:00;476;311;165;Bedeckt;-5;-5;0
24/01/2019;10:00;213;126;87;Bedeckt;-4;-4;0
24/01/2019;11:00;335;162;173;Leichter Schneefall;-3;-3;0
24/01/2019;12:00;313;125;188;Leichter Schneefall;-2;-3;0
24/01/2019;13:00;541;218;323;Leichter Schneefall;-2;-3;0
24/01/2019;14:00;320;146;174;Bedeckt;-1;-2;0
24/01/2019;15:00;576;273;303;Bedeckt;-1;-2;0
24/01/2019;16:00;589;301;288;Bedeckt;-1;-2;0
24/01/2019;17:00;641;281;360;Leichter Schneefall;-2;-3;0
24/01/2019;18:00;540;252;288;Leichter Schneefall;-2;-3;0
24/01/2019;19:00;344;163;181;Leichter Schneefall;-2;-4;0
24/01/2019;20:00;269;106;163;Mäßiger Schneefall;-3;-4;0
24/01/2019;21:00;193;89;104;Mäßiger Schneefall;-3;-5;0
24/01/2019;22:00;136;52;84;Mäßiger Schneefall;-3;-5;0
24/01/2019;23:00;107;41;66;Mäßiger Schneefall;-3;-6;0
25/01/2019;00:00;59;14;45;Mäßiger Schneefall;-4;-6;0
25/01/2019;01:00;20;6;14;Mäßiger Schneefall;-4;-6;0
25/01/2019;02:00;12;7;5;Bedeckt;-4;-6;0
25/01/2019;03:00;8;2;6;Bedeckt;-5;-6;0
25/01/2019;04:00;8;3;5;Bedeckt;-5;-5;0
25/01/2019;05:00;22;14;8;Mäßiger Schneefall;-5;-5;0
25/01/2019;06:00;119;69;50;Mäßiger Schneefall;-5;-5;0
25/01/2019;07:00;636;396;240;Mäßiger Schneefall;-5;-6;0
25/01/2019;08:00;522;316;206;Mäßiger Schneefall;-5;-6;0
25/01/2019;09:00;439;270;169;Mäßiger Schneefall;-4;-6;0
25/01/2019;10:00;274;158;116;Mäßiger Schneefall;-3;-6;0
25/01/2019;11:00;323;159;164;Leicht bewölkt;-3;-5;0
25/01/2019;12:00;474;229;245;Leicht bewölkt;-2;-5;0
25/01/2019;13:00;614;228;386;Leicht bewölkt;-2;-4;0
25/01/2019;14:00;433;220;213;Leicht bewölkt;-1;-4;0
25/01/2019;15:00;449;213;236;Leicht bewölkt;-1;-3;0
25/01/2019;16:00;445;205;240;Leicht bewölkt;-1;-4;0
25/01/2019;17:00;494;218;276;Leicht bewölkt;-2;-4;0
25/01/2019;18:00;402;185;217;Leicht bewölkt;-2;-5;0
25/01/2019;19:00;350;178;172;Leicht bewölkt;-3;-5;0
25/01/2019;20:00;227;127;100;Leicht bewölkt;-4;-5;0
25/01/2019;21:00;158;71;87;Leicht bewölkt;-5;-6;0
25/01/2019;22:00;175;65;110;Leicht bewölkt;-4;-6;0
25/01/2019;23:00;131;43;88;Bedeckt;-3;-5;0
26/01/2019;00:00;81;15;66;Bedeckt;-3;-5;0
26/01/2019;01:00;65;22;43;Bedeckt;-2;-5;0
26/01/2019;02:00;25;14;11;Bewölkt;-1;-5;0
26/01/2019;03:00;22;9;13;Bewölkt;-1;-5;0
26/01/2019;04:00;16;7;9;Bewölkt;0;-5;0
26/01/2019;05:00;17;10;7;Mäßiger Schneefall;0;-4;0
26/01/2019;06:00;31;18;13;Mäßiger Schneefall;0;-4;0
26/01/2019;07:00;64;39;25;Mäßiger Schneefall;1;-3;0
26/01/2019;08:00;137;85;52;Bedeckt;2;-2;0
26/01/2019;09:00;234;156;78;Bedeckt;2;-1;0
26/01/2019;10:00;282;179;103;Bedeckt;3;-1;0
26/01/2019;11:00;306;176;130;Leichter Eisregen;4;0;0
26/01/2019;12:00;278;139;139;Leichter Eisregen;4;1;0
26/01/2019;13:00;307;159;148;Leichter Eisregen;5;1;0
26/01/2019;14:00;300;153;147;Bedeckt;5;2;0
26/01/2019;15:00;262;122;140;Bedeckt;5;2;0
26/01/2019;16:00;276;140;136;Bedeckt;4;1;0
26/01/2019;17:00;328;154;174;Bedeckt;4;1;0
26/01/2019;18:00;257;109;148;Bedeckt;4;1;0
26/01/2019;19:00;246;115;131;Bedeckt;3;0;0
26/01/2019;20:00;220;111;109;Bedeckt;3;0;0
26/01/2019;21:00;156;83;73;Bedeckt;3;0;0
26/01/2019;22:00;102;40;62;Bedeckt;2;-1;0
26/01/2019;23:00;94;34;60;Leicht bewölkt;2;-1;0
27/01/2019;00:00;113;34;79;Leicht bewölkt;2;-1;0
27/01/2019;01:00;72;28;44;Leicht bewölkt;1;-1;0
27/01/2019;02:00;44;14;30;Leicht bewölkt;1;-1;0
27/01/2019;03:00;37;6;31;Leicht bewölkt;1;-2;0
27/01/2019;04:00;14;6;8;Leicht bewölkt;1;-2;0
27/01/2019;05:00;13;6;7;Leicht bewölkt;1;-2;0
27/01/2019;06:00;16;7;9;Leicht bewölkt;1;-2;0
27/01/2019;07:00;22;10;12;Leicht bewölkt;2;-1;0
27/01/2019;08:00;34;19;15;Leicht bewölkt;2;0;0
27/01/2019;09:00;124;94;30;Leicht bewölkt;3;0;0
27/01/2019;10:00;130;77;53;Leicht bewölkt;3;1;0
27/01/2019;11:00;144;70;74;Stellenweiser Nieselregen;3;2;0
27/01/2019;12:00;165;82;83;Stellenweiser Nieselregen;4;2;0
27/01/2019;13:00;169;96;73;Stellenweiser Nieselregen;4;2;0
27/01/2019;14:00;227;110;117;Leichter Regenfall;4;2;0
27/01/2019;15:00;183;85;98;Leichter Regenfall;4;2;0
27/01/2019;16:00;185;97;88;Leichter Regenfall;4;1;0
27/01/2019;17:00;193;99;94;Nieselregen;4;1;0
27/01/2019;18:00;236;104;132;Nieselregen;3;0;0
27/01/2019;19:00;165;76;89;Nieselregen;2;0;0
27/01/2019;20:00;131;59;72;Stellenweiser Nieselregen;1;0;0
27/01/2019;21:00;74;29;45;Stellenweiser Nieselregen;1;-1;0
27/01/2019;22:00;78;34;44;Stellenweiser Nieselregen;1;-1;0
27/01/2019;23:00;45;22;23;Mäßiger Schneefall;1;-2;0
28/01/2019;00:00;26;8;18;Mäßiger Schneefall;1;-3;0
28/01/2019;01:00;14;4;10;Mäßiger Schneefall;1;-3;0
28/01/2019;02:00;16;2;14;Bedeckt;1;-4;0
28/01/2019;03:00;1;0;1;Bedeckt;1;-4;0
28/01/2019;04:00;7;4;3;Bedeckt;1;-5;0
28/01/2019;05:00;17;10;7;Starker Schneefall;1;-5;0
28/01/2019;06:00;113;65;48;Starker Schneefall;1;-5;0
28/01/2019;07:00;630;373;257;Starker Schneefall;1;-5;0
28/01/2019;08:00;530;296;234;Schneesturm;1;-5;0
28/01/2019;09:00;444;272;172;Schneesturm;1;-5;0
28/01/2019;10:00;304;170;134;Schneesturm;1;-4;0
28/01/2019;11:00;311;144;167;Mäßiger Schneefall;2;-4;0
28/01/2019;12:00;421;197;224;Mäßiger Schneefall;2;-4;0
28/01/2019;13:00;569;210;359;Mäßiger Schneefall;2;-4;0
28/01/2019;14:00;339;168;171;Leicht bewölkt;2;-4;0
28/01/2019;15:00;504;258;246;Leicht bewölkt;2;-4;0
28/01/2019;16:00;535;262;273;Leicht bewölkt;2;-4;0
28/01/2019;17:00;641;304;337;Starker Schneefall;1;-4;0
28/01/2019;18:00;467;208;259;Starker Schneefall;1;-4;0
28/01/2019;19:00;411;206;205;Starker Schneefall;1;-4;0
28/01/2019;20:00;275;127;148;Bedeckt;1;-4;0
28/01/2019;21:00;141;59;82;Bedeckt;1;-4;0
28/01/2019;22:00;152;64;88;Bedeckt;1;-4;0
28/01/2019;23:00;75;29;46;Starker Schneefall;0;-4;0
29/01/2019;00:00;22;10;12;Starker Schneefall;0;-4;0
29/01/2019;01:00;20;3;17;Starker Schneefall;0;-4;0
29/01/2019;02:00;6;2;4;Bedeckt;0;-3;0
29/01/2019;03:00;5;2;3;Bedeckt;0;-3;0
29/01/2019;04:00;7;5;2;Bedeckt;0;-3;0
29/01/2019;05:00;36;21;15;Mäßige bis starke Schneefälle;0;-3;0
29/01/2019;06:00;133;84;49;Mäßige bis starke Schneefälle;-1;-4;0
29/01/2019;07:00;638;403;235;Mäßige bis starke Schneefälle;-1;-3;0
29/01/2019;08:00;528;287;241;Mäßige bis starke Schneefälle;-1;-3;0
29/01/2019;09:00;488;289;199;Mäßige bis starke Schneefälle;-1;-2;0
29/01/2019;10:00;307;154;153;Mäßige bis starke Schneefälle;0;-2;0
29/01/2019;11:00;348;181;167;Starker Schneefall;1;-1;0
29/01/2019;12:00;417;175;242;Starker Schneefall;1;0;0
29/01/2019;13:00;571;226;345;Starker Schneefall;1;0;0
29/01/2019;14:00;436;211;225;Stellenweise leichter Schneefall;2;0;0
29/01/2019;15:00;604;312;292;Stellenweise leichter Schneefall;2;0;0
29/01/2019;16:00;569;294;275;Stellenweise leichter Schneefall;1;-1;0
29/01/2019;17:00;621;297;324;Bedeckt;0;-3;0
29/01/2019;18:00;574;252;322;Bedeckt;-1;-4;0
29/01/2019;19:00;491;215;276;Bedeckt;-2;-5;0
29/01/2019;20:00;281;129;152;Leicht bewölkt;-2;-5;0
29/01/2019;21:00;218;103;115;Leicht bewölkt;-3;-6;0
29/01/2019;22:00;156;59;97;Leicht bewölkt;-3;-6;0
29/01/2019;23:00;95;38;57;Leicht bewölkt;-3;-5;0
30/01/2019;00:00;43;18;25;Leicht bewölkt;-3;-5;0
30/01/2019;01:00;15;7;8;Leicht bewölkt;-2;-5;0
30/01/2019;02:00;18;7;11;Bedeckt;-2;-4;0
30/01/2019;03:00;3;1;2;Bedeckt;-1;-3;0
30/01/2019;04:00;6;4;2;Bedeckt;-1;-3;0
30/01/2019;05:00;28;16;12;Bewölkt;-1;-3;0
30/01/2019;06:00;115;69;46;Bewölkt;-1;-3;0
30/01/2019;07:00;673;412;261;Bewölkt;-1;-3;0
30/01/2019;08:00;558;326;232;Bewölkt;0;-3;0
30/01/2019;09:00;462;286;176;Bewölkt;1;-3;0
30/01/2019;10:00;261;139;122;Bewölkt;1;-2;0
30/01/2019;11:00;335;157;178;Stellenweise leichter Schneefall;2;-2;0
30/01/2019;12:00;393;186;207;Stellenweise leichter Schneefall;2;-2;0
30/01/2019;13:00;652;300;352;Stellenweise leichter Schneefall;2;-2;0
30/01/2019;14:00;399;190;209;Mäßige bis starke Schneefälle;2;-3;0
30/01/2019;15:00;487;210;277;Mäßige bis starke Schneefälle;2;-3;0
30/01/2019;16:00;489;222;267;Mäßige bis starke Schneefälle;1;-3;0
30/01/2019;17:00;594;291;303;Mäßige bis starke Schneefälle;1;-4;0
30/01/2019;18:00;537;218;319;Mäßige bis starke Schneefälle;0;-4;0
30/01/2019;19:00;382;156;226;Mäßige bis starke Schneefälle;-1;-5;0
30/01/2019;20:00;277;135;142;Bedeckt;-1;-5;0
30/01/2019;21:00;201;89;112;Bedeckt;-2;-5;0
30/01/2019;22:00;138;68;70;Bedeckt;-2;-5;0
30/01/2019;23:00;91;34;57;Bedeckt;-2;-5;0
31/01/2019;00:00;50;25;25;Bedeckt;-2;-5;0
31/01/2019;01:00;25;6;19;Bedeckt;-3;-5;0
31/01/2019;02:00;15;6;9;Leicht bewölkt;-3;-6;0
31/01/2019;03:00;4;2;2;Leicht bewölkt;-4;-7;0
31/01/2019;04:00;5;3;2;Leicht bewölkt;-4;-7;0
31/01/2019;05:00;24;15;9;Leicht bewölkt;-5;-8;0
31/01/2019;06:00;119;75;44;Leicht bewölkt;-5;-8;0
31/01/2019;07:00;610;353;257;Leicht bewölkt;-4;-7;0
31/01/2019;08:00;536;305;231;Leicht bewölkt;-3;-6;0
31/01/2019;09:00;489;315;174;Leicht bewölkt;-3;-5;0
31/01/2019;10:00;281;151;130;Leicht bewölkt;-1;-3;0
31/01/2019;11:00;360;175;185;Leicht bewölkt;0;-1;0
31/01/2019;12:00;363;159;204;Leicht bewölkt;1;1;0
31/01/2019;13:00;540;237;303;Leicht bewölkt;2;1;0
31/01/2019;14:00;372;176;196;Leicht bewölkt;2;1;0
31/01/2019;15:00;606;269;337;Leicht bewölkt;3;2;0
31/01/2019;16:00;577;279;298;Leicht bewölkt;2;1;0
31/01/2019;17:00;668;306;362;Leicht bewölkt;1;0;0
31/01/2019;18:00;558;267;291;Leicht bewölkt;1;-1;0
31/01/2019;19:00;366;158;208;Leicht bewölkt;0;-2;0
31/01/2019;20:00;272;106;166;Leicht bewölkt;-1;-3;0
31/01/2019;21:00;206;82;124;Leicht bewölkt;-3;-3;0
31/01/2019;22:00;166;73;93;Leicht bewölkt;-2;-3;0
31/01/2019;23:00;99;35;64;Leicht bewölkt;-1;-2;0
01/02/2019;00:00;46;17;29;Leicht bewölkt;0;-2;0
01/02/2019;01:00;41;13;28;Leicht bewölkt;1;-1;0
01/02/2019;02:00;17;4;13;Leicht bewölkt;1;0;0
01/02/2019;03:00;2;1;1;Leicht bewölkt;2;0;0
01/02/2019;04:00;3;2;1;Leicht bewölkt;2;1;0
01/02/2019;05:00;25;19;6;Leicht bewölkt;2;1;0
01/02/2019;06:00;119;74;45;Leicht bewölkt;2;1;0
01/02/2019;07:00;607;362;245;Leicht bewölkt;2;1;0
01/02/2019;08:00;534;317;217;Bewölkt;3;2;0
01/02/2019;09:00;461;287;174;Bewölkt;3;2;0
01/02/2019;10:00;291;182;109;Bewölkt;3;2;0
01/02/2019;11:00;414;190;224;Stellenweiser Regenfall;4;2;0
01/02/2019;12:00;506;234;272;Stellenweiser Regenfall;4;3;0
01/02/2019;13:00;714;318;396;Stellenweiser Regenfall;4;3;0
01/02/2019;14:00;476;193;283;Bewölkt;4;3;0
01/02/2019;15:00;488;210;278;Bewölkt;4;3;0
01/02/2019;16:00;537;273;264;Bewölkt;4;2;0
01/02/2019;17:00;508;250;258;Stellenweiser Regenfall;3;1;0
01/02/2019;18:00;415;194;221;Stellenweiser Regenfall;3;1;0
01/02/2019;19:00;366;165;201;Stellenweiser Regenfall;2;0;0
01/02/2019;20:00;224;96;128;Bedeckt;2;0;0
01/02/2019;21:00;141;57;84;Bedeckt;2;-1;0
01/02/2019;22:00;145;53;92;Bedeckt;1;-1;0
01/02/2019;23:00;121;32;89;Stellenweiser Nieselregen;1;-1;0
02/02/2019;00:00;96;26;70;Stellenweiser Nieselregen;1;-1;0
02/02/2019;01:00;51;25;26;Stellenweiser Nieselregen;1;-1;0
02/02/2019;02:00;45;15;30;Leichter Eisregen;1;0;0
02/02/2019;03:00;17;3;14;Leichter Eisregen;1;1;0
02/02/2019;04:00;7;3;4;Leichter Eisregen;1;1;0
02/02/2019;05:00;16;10;6;Nieselregen;2;1;0
02/02/2019;06:00;31;20;11;Nieselregen;2;2;0
02/02/2019;07:00;41;27;14;Nieselregen;2;2;0
02/02/2019;08:00;140;94;46;Leichter Regenfall;3;2;0
02/02/2019;09:00;196;128;68;Leichter Regenfall;3;2;0
02/02/2019;10:00;286;162;124;Leichter Regenfall;4;3;1
02/02/2019;11:00;274;150;124;Leichter Regenfall;4;4;1
02/02/2019;12:00;325;182;143;Leichter Regenfall;5;5;1
02/02/2019;13:00;340;189;151;Leichter Regenfall;5;5;0
02/02/2019;14:00;321;143;178;Stellenweiser Regenfall;5;5;0
02/02/2019;15:00;328;143;185;Stellenweiser Regenfall;5;4;0
02/02/2019;16:00;258;99;159;Stellenweiser Regenfall;4;3;0
02/02/2019;17:00;268;112;156;Leichter Nebel;3;2;0
02/02/2019;18:00;290;124;166;Leichter Nebel;3;0;0
02/02/2019;19:00;198;92;106;Leichter Nebel;1;0;0
02/02/2019;20:00;190;85;105;Nebel;0;-1;0
02/02/2019;21:00;167;92;75;Nebel;-1;-2;0
02/02/2019;22:00;113;48;65;Nebel;-1;-2;0
02/02/2019;23:00;118;43;75;Leichter Nebel;0;-2;0
03/02/2019;00:00;106;27;79;Leichter Nebel;1;-1;0
03/02/2019;01:00;57;16;41;Leichter Nebel;1;-1;0
03/02/2019;02:00;48;15;33;Starker Schneefall;2;-1;0
03/02/2019;03:00;30;4;26;Starker Schneefall;2;-1;1
03/02/2019;04:00;7;4;3;Starker Schneefall;2;-1;1
03/02/2019;05:00;8;8;0;Starker Schneefall;2;-1;1
03/02/2019;06:00;21;6;15;Starker Schneefall;2;-1;1
03/02/2019;07:00;13;9;4;Starker Schneefall;2;-1;1
03/02/2019;08:00;31;19;12;Starker Schneefall;2;-1;1
03/02/2019;09:00;68;34;34;Starker Schneefall;2;-2;1
03/02/2019;10:00;86;54;32;Starker Schneefall;2;-2;1
03/02/2019;11:00;105;63;42;Starker Schneefall;1;-2;1
03/02/2019;12:00;92;48;44;Starker Schneefall;1;-3;1
03/02/2019;13:00;114;58;56;Starker Schneefall;1;-3;1
03/02/2019;14:00;144;75;69;Starker Schneefall;1;-3;1
03/02/2019;15:00;97;54;43;Starker Schneefall;1;-3;1
03/02/2019;16:00;103;48;55;Starker Schneefall;0;-3;1
03/02/2019;17:00;143;70;73;Starker Schneefall;0;-3;0
03/02/2019;18:00;142;49;93;Starker Schneefall;0;-3;0
03/02/2019;19:00;123;58;65;Starker Schneefall;0;-2;0
03/02/2019;20:00;92;44;48;Starker Schneefall;0;-2;0
03/02/2019;21:00;59;19;40;Starker Schneefall;-1;-2;0
03/02/2019;22:00;77;32;45;Starker Schneefall;-1;-3;0
03/02/2019;23:00;45;19;26;Starker Schneefall;-2;-3;0
04/02/2019;00:00;14;5;9;Starker Schneefall;-3;-4;0
04/02/2019;01:00;12;6;6;Starker Schneefall;-3;-4;0
04/02/2019;02:00;13;5;8;Starker Schneefall;-4;-5;0
04/02/2019;03:00;7;1;6;Starker Schneefall;-4;-6;0
04/02/2019;04:00;37;25;12;Starker Schneefall;-5;-6;0
04/02/2019;05:00;28;14;14;Leichter Nebel;-5;-7;0
04/02/2019;06:00;91;59;32;Leichter Nebel;-5;-7;0
04/02/2019;07:00;577;338;239;Leichter Nebel;-4;-6;0
04/02/2019;08:00;424;208;216;Leicht bewölkt;-3;-5;0
04/02/2019;09:00;363;213;150;Leicht bewölkt;-2;-3;0
04/02/2019;10:00;243;148;95;Leicht bewölkt;-1;-2;0
04/02/2019;11:00;271;141;130;Sonnig;0;-1;0
04/02/2019;12:00;324;152;172;Sonnig;1;0;0
04/02/2019;13:00;540;257;283;Sonnig;1;0;0
04/02/2019;14:00;384;186;198;Leicht bewölkt;2;0;0
04/02/2019;15:00;544;261;283;Leicht bewölkt;2;0;0
04/02/2019;16:00;533;247;286;Leicht bewölkt;1;-1;0
04/02/2019;17:00;578;248;330;Leicht bewölkt;0;-2;0
04/02/2019;18:00;470;235;235;Leicht bewölkt;-1;-3;0
04/02/2019;19:00;375;165;210;Leicht bewölkt;-2;-3;0
04/02/2019;20:00;262;107;155;Leicht bewölkt;-3;-3;0
04/02/2019;21:00;178;72;106;Leicht bewölkt;-3;-4;0
04/02/2019;22:00;138;61;77;Leicht bewölkt;-3;-4;0
04/02/2019;23:00;81;30;51;Bedeckt;-3;-3;0
05/02/2019;00:00;37;14;23;Bedeckt;-3;-3;0
05/02/2019;01:00;8;4;4;Bedeckt;-3;-3;0
05/02/2019;02:00;13;7;6;Leicht bewölkt;-3;-3;0
05/02/2019;03:00;5;2;3;Leicht bewölkt;-3;-3;0
05/02/2019;04:00;8;8;0;Leicht bewölkt;-3;-3;0
05/02/2019;05:00;22;17;5;Leicht bewölkt;-3;-3;0
05/02/2019;06:00;144;89;55;Leicht bewölkt;-4;-4;0
05/02/2019;07:00;674;415;259;Leicht bewölkt;-3;-3;0
05/02/2019;08:00;523;277;246;Leicht bewölkt;-2;-2;0
05/02/2019;09:00;476;286;190;Leicht bewölkt;-1;-1;0
05/02/2019;10:00;253;138;115;Leicht bewölkt;0;0;0
05/02/2019;11:00;353;156;197;Leicht bewölkt;2;2;0
05/02/2019;12:00;366;152;214;Leicht bewölkt;3;3;0
05/02/2019;13:00;561;223;338;Leicht bewölkt;3;3;0
05/02/2019;14:00;398;193;205;Leicht bewölkt;3;3;0
05/02/2019;15:00;547;263;284;Leicht bewölkt;4;3;0
05/02/2019;16:00;503;256;247;Leicht bewölkt;2;1;0
05/02/2019;17:00;628;304;324;Leicht bewölkt;1;0;0
05/02/2019;18:00;526;249;277;Leicht bewölkt;0;-1;0
05/02/2019;19:00;482;247;235;Leicht bewölkt;-1;-2;0
05/02/2019;20:00;269;129;140;Leicht bewölkt;-2;-2;0
05/02/2019;21:00;172;82;90;Leicht bewölkt;-2;-3;0
05/02/2019;22:00;183;57;126;Leicht bewölkt;-2;-3;0
05/02/2019;23:00;66;23;43;Leicht bewölkt;-2;-2;0
06/02/2019;00:00;35;17;18;Leicht bewölkt;-2;-2;0
06/02/2019;01:00;20;6;14;Leicht bewölkt;-2;-2;0
06/02/2019;02:00;4;1;3;Leicht bewölkt;-3;-3;0
06/02/2019;03:00;2;1;1;Leicht bewölkt;-3;-3;0
06/02/2019;04:00;4;2;2;Leicht bewölkt;-3;-3;0
06/02/2019;05:00;27;15;12;Leicht bewölkt;-3;-3;0
06/02/2019;06:00;108;66;42;Leicht bewölkt;-3;-3;0
06/02/2019;07:00;695;377;318;Leicht bewölkt;-2;-2;0
06/02/2019;08:00;554;325;229;Leicht bewölkt;-1;-1;0
06/02/2019;09:00;489;309;180;Leicht bewölkt;0;0;0
06/02/2019;10:00;270;144;126;Leicht bewölkt;1;1;0
06/02/2019;11:00;337;174;163;Leicht bewölkt;2;2;0
06/02/2019;12:00;440;200;240;Leicht bewölkt;3;3;0
06/02/2019;13:00;613;274;339;Leicht bewölkt;4;3;0
06/02/2019;14:00;408;188;220;Bewölkt;4;4;0
06/02/2019;15:00;495;213;282;Bewölkt;5;4;0
06/02/2019;16:00;490;259;231;Bewölkt;4;4;0
06/02/2019;17:00;601;266;335;Leicht bewölkt;4;4;0
06/02/2019;18:00;537;243;294;Leicht bewölkt;3;3;0
06/02/2019;19:00;415;204;211;Leicht bewölkt;2;2;0
06/02/2019;20:00;324;167;157;Leicht bewölkt;1;1;0
06/02/2019;21:00;182;76;106;Leicht bewölkt;0;0;0
06/02/2019;22:00;177;85;92;Leicht bewölkt;0;-1;0
06/02/2019;23:00;93;28;65;Leicht bewölkt;-1;-1;0
07/02/2019;00:00;49;13;36;Leicht bewölkt;-1;-2;0
07/02/2019;01:00;29;10;19;Leicht bewölkt;-1;-2;0
07/02/2019;02:00;24;8;16;Leicht bewölkt;-1;-2;0
07/02/2019;03:00;5;2;3;Leicht bewölkt;-1;-3;0
07/02/2019;04:00;6;5;1;Leicht bewölkt;-1;-3;0
07/02/2019;05:00;27;18;9;Leicht bewölkt;-1;-3;0
07/02/2019;06:00;115;71;44;Leicht bewölkt;-1;-3;0
07/02/2019;07:00;633;373;260;Leicht bewölkt;0;-2;0
07/02/2019;08:00;519;289;230;Bedeckt;1;-1;0
07/02/2019;09:00;423;255;168;Bedeckt;2;1;0
07/02/2019;10:00;237;129;108;Bedeckt;4;2;0
07/02/2019;11:00;347;156;191;Stellenweiser Regenfall;5;4;0
07/02/2019;12:00;377;161;216;Stellenweiser Regenfall;6;5;0
07/02/2019;13:00;480;192;288;Stellenweiser Regenfall;6;5;0
07/02/2019;14:00;330;147;183;Leicht bewölkt;7;5;0
07/02/2019;15:00;457;214;243;Leicht bewölkt;7;5;0
07/02/2019;16:00;466;230;236;Leicht bewölkt;6;4;0
07/02/2019;17:00;580;265;315;Bewölkt;5;4;0
07/02/2019;18:00;489;219;270;Bewölkt;5;3;0
07/02/2019;19:00;339;160;179;Bewölkt;4;2;0
07/02/2019;20:00;247;114;133;Stellenweiser Regenfall;3;1;0
07/02/2019;21:00;157;74;83;Stellenweiser Regenfall;2;1;0
07/02/2019;22:00;164;71;93;Stellenweiser Regenfall;2;1;0
07/02/2019;23:00;83;38;45;Nieselregen;2;0;0
08/02/2019;00:00;49;23;26;Nieselregen;3;0;0
08/02/2019;01:00;29;4;25;Nieselregen;3;0;0
08/02/2019;02:00;20;13;7;Stellenweiser Nieselregen;4;0;0
08/02/2019;03:00;11;4;7;Stellenweiser Nieselregen;4;0;0
08/02/2019;04:00;6;3;3;Stellenweiser Nieselregen;4;0;0
08/02/2019;05:00;19;10;9;Stellenweiser Nieselregen;4;0;0
08/02/2019;06:00;114;71;43;Stellenweiser Nieselregen;4;0;0
08/02/2019;07:00;623;381;242;Stellenweiser Nieselregen;4;1;0
08/02/2019;08:00;548;306;242;Stellenweiser Nieselregen;4;1;0
08/02/2019;09:00;489;308;181;Stellenweiser Nieselregen;5;2;0
08/02/2019;10:00;340;185;155;Stellenweiser Nieselregen;5;2;0
08/02/2019;11:00;511;285;226;Leicht bewölkt;6;3;0
08/02/2019;12:00;534;210;324;Leicht bewölkt;7;4;0
08/02/2019;13:00;672;265;407;Leicht bewölkt;7;4;0
08/02/2019;14:00;520;230;290;Leicht bewölkt;7;4;0
08/02/2019;15:00;509;228;281;Leicht bewölkt;7;4;0
08/02/2019;16:00;539;262;277;Leicht bewölkt;6;4;0
08/02/2019;17:00;504;225;279;Leicht bewölkt;5;3;0
08/02/2019;18:00;450;212;238;Leicht bewölkt;4;2;0
08/02/2019;19:00;335;178;157;Leicht bewölkt;3;2;0
08/02/2019;20:00;251;119;132;Leicht bewölkt;3;1;0
08/02/2019;21:00;168;104;64;Leicht bewölkt;2;1;0
08/02/2019;22:00;144;51;93;Leicht bewölkt;2;1;0
08/02/2019;23:00;126;25;101;Leicht bewölkt;3;1;0
09/02/2019;00:00;87;20;67;Leicht bewölkt;3;1;0
09/02/2019;01:00;53;6;47;Leicht bewölkt;3;1;0
09/02/2019;02:00;35;17;18;Bewölkt;3;1;0
09/02/2019;03:00;29;9;20;Bewölkt;3;1;0
09/02/2019;04:00;8;4;4;Bewölkt;3;0;0
09/02/2019;05:00;24;20;4;Leicht bewölkt;3;0;0
09/02/2019;06:00;47;35;12;Leicht bewölkt;3;0;0
09/02/2019;07:00;52;27;25;Leicht bewölkt;3;0;0
09/02/2019;08:00;112;63;49;Leicht bewölkt;4;1;0
09/02/2019;09:00;235;131;104;Leicht bewölkt;5;2;0
09/02/2019;10:00;299;176;123;Leicht bewölkt;6;4;0
09/02/2019;11:00;334;167;167;Leicht bewölkt;7;5;0
09/02/2019;12:00;314;171;143;Leicht bewölkt;9;6;0
09/02/2019;13:00;346;178;168;Leicht bewölkt;9;7;0
09/02/2019;14:00;377;182;195;Leicht bewölkt;9;7;0
09/02/2019;15:00;318;141;177;Leicht bewölkt;9;7;0
09/02/2019;16:00;305;136;169;Leicht bewölkt;9;7;0
09/02/2019;17:00;280;136;144;Leicht bewölkt;8;6;0
09/02/2019;18:00;295;147;148;Leicht bewölkt;7;5;0
09/02/2019;19:00;226;98;128;Leicht bewölkt;6;4;0
09/02/2019;20:00;227;118;109;Leicht bewölkt;5;3;0
09/02/2019;21:00;145;79;66;Leicht bewölkt;4;2;0
09/02/2019;22:00;142;56;86;Leicht bewölkt;3;2;0
09/02/2019;23:00;113;38;75;Leicht bewölkt;3;1;0
10/02/2019;00:00;102;24;78;Leicht bewölkt;2;1;0
10/02/2019;01:00;88;31;57;Leicht bewölkt;3;1;0
10/02/2019;02:00;55;23;32;Leicht bewölkt;3;1;0
10/02/2019;03:00;37;11;26;Leicht bewölkt;3;1;0
10/02/2019;04:00;11;9;2;Leicht bewölkt;3;1;0
10/02/2019;05:00;18;12;6;Bedeckt;3;1;0
10/02/2019;06:00;20;12;8;Bedeckt;3;1;0
10/02/2019;07:00;24;11;13;Bedeckt;3;1;0
10/02/2019;08:00;60;34;26;Leicht bewölkt;4;2;0
10/02/2019;09:00;128;61;67;Leicht bewölkt;5;2;0
10/02/2019;10:00;143;84;59;Leicht bewölkt;6;3;0
10/02/2019;11:00;175;82;93;Leicht bewölkt;7;5;0
10/02/2019;12:00;205;112;93;Leicht bewölkt;9;6;0
10/02/2019;13:00;219;98;121;Leicht bewölkt;8;6;0
10/02/2019;14:00;223;122;101;Leicht bewölkt;8;6;0
10/02/2019;15:00;178;94;84;Leicht bewölkt;8;6;0
10/02/2019;16:00;187;90;97;Leicht bewölkt;7;5;0
10/02/2019;17:00;157;88;69;Nieselregen;7;3;0
10/02/2019;18:00;156;82;74;Nieselregen;6;2;0
10/02/2019;19:00;124;60;64;Nieselregen;6;1;0
10/02/2019;20:00;79;38;41;Leichter Regenfall;5;0;0
10/02/2019;21:00;79;30;49;Leichter Regenfall;5;-1;0
10/02/2019;22:00;55;18;37;Leichter Regenfall;5;-1;0
10/02/2019;23:00;25;14;11;Stellenweiser Nieselregen;4;-1;0
11/02/2019;00:00;13;6;7;Stellenweiser Nieselregen;4;-2;0
11/02/2019;01:00;12;1;11;Stellenweiser Nieselregen;4;-2;0
11/02/2019;02:00;11;3;8;Leichter Eisregen;4;-2;0
11/02/2019;03:00;1;0;1;Leichter Eisregen;3;-2;1
11/02/2019;04:00;6;3;3;Leichter Eisregen;3;-2;1
11/02/2019;05:00;28;15;13;Leichter Eisregen;3;-2;1
11/02/2019;06:00;101;55;46;Leichter Eisregen;3;-3;1
11/02/2019;07:00;636;384;252;Leichter Eisregen;3;-2;0
11/02/2019;08:00;505;271;234;Mäßige bis starke Schneefälle;3;-2;0
11/02/2019;09:00;445;254;191;Mäßige bis starke Schneefälle;3;-2;0
11/02/2019;10:00;268;159;109;Mäßige bis starke Schneefälle;3;-2;0
11/02/2019;11:00;377;172;205;Mäßige bis starke Schneefälle;3;-1;0
11/02/2019;12:00;371;171;200;Mäßige bis starke Schneefälle;4;-1;0
11/02/2019;13:00;528;191;337;Mäßige bis starke Schneefälle;4;-1;0
11/02/2019;14:00;406;220;186;Bewölkt;4;0;0
11/02/2019;15:00;550;272;278;Bewölkt;4;0;0
11/02/2019;16:00;571;297;274;Bewölkt;4;0;0
11/02/2019;17:00;590;264;326;Leichte Eisregen;3;-1;0
11/02/2019;18:00;468;227;241;Leichte Eisregen;2;-1;0
11/02/2019;19:00;394;186;208;Leichte Eisregen;2;-1;0
11/02/2019;20:00;304;145;159;Mäßige bis starke Schneefälle;1;-1;0
11/02/2019;21:00;171;75;96;Mäßige bis starke Schneefälle;0;-1;0
11/02/2019;22:00;137;63;74;Mäßige bis starke Schneefälle;0;-1;0
11/02/2019;23:00;62;22;40;Mäßige bis starke Schneefälle;1;-1;0
12/02/2019;00:00;21;4;17;Mäßige bis starke Schneefälle;1;-2;0
12/02/2019;01:00;23;8;15;Mäßige bis starke Schneefälle;1;-2;0
12/02/2019;02:00;11;8;3;Bedeckt;1;-2;0
12/02/2019;03:00;8;4;4;Bedeckt;2;-2;0
12/02/2019;04:00;6;1;5;Bedeckt;2;-2;0
12/02/2019;05:00;27;16;11;Mäßige bis starke Schneefälle;2;-1;0
12/02/2019;06:00;129;83;46;Mäßige bis starke Schneefälle;2;-1;0
12/02/2019;07:00;668;407;261;Mäßige bis starke Schneefälle;2;-1;0
12/02/2019;08:00;557;285;272;Mäßige bis starke Schneefälle;2;-1;0
12/02/2019;09:00;458;267;191;Mäßige bis starke Schneefälle;2;-1;0
12/02/2019;10:00;273;147;126;Mäßige bis starke Schneefälle;3;0;0
12/02/2019;11:00;403;178;225;Leichter Schneefall;3;1;0
12/02/2019;12:00;445;186;259;Leichter Schneefall;4;2;0
12/02/2019;13:00;587;248;339;Leichter Schneefall;4;3;0
12/02/2019;14:00;370;175;195;Bedeckt;4;3;0
12/02/2019;15:00;648;298;350;Bedeckt;5;4;0
12/02/2019;16:00;561;291;270;Bedeckt;4;3;0
12/02/2019;17:00;678;309;369;Bedeckt;3;3;0
12/02/2019;18:00;539;276;263;Bedeckt;2;2;0
12/02/2019;19:00;452;209;243;Bedeckt;2;1;0
12/02/2019;20:00;263;106;157;Leicht bewölkt;1;0;0
12/02/2019;21:00;194;83;111;Leicht bewölkt;0;-1;0
12/02/2019;22:00;165;62;103;Leicht bewölkt;0;-1;0
12/02/2019;23:00;80;46;34;Leicht bewölkt;-1;-1;0
13/02/2019;00:00;53;16;37;Leicht bewölkt;-1;-2;0
13/02/2019;01:00;27;6;21;Leicht bewölkt;-1;-2;0
13/02/2019;02:00;13;1;12;Leicht bewölkt;-1;-2;0
13/02/2019;03:00;15;6;9;Leicht bewölkt;-1;-2;0
13/02/2019;04:00;2;1;1;Leicht bewölkt;-1;-2;0
13/02/2019;05:00;29;18;11;Leicht bewölkt;-1;-2;0
13/02/2019;06:00;116;75;41;Leicht bewölkt;-1;-3;0
13/02/2019;07:00;700;413;287;Leicht bewölkt;0;-1;0
13/02/2019;08:00;553;311;242;Leicht bewölkt;1;0;0
13/02/2019;09:00;454;282;172;Leicht bewölkt;2;1;0
13/02/2019;10:00;255;134;121;Leicht bewölkt;3;2;0
13/02/2019;11:00;393;189;204;Leicht bewölkt;5;4;0
13/02/2019;12:00;456;207;249;Leicht bewölkt;6;5;0
13/02/2019;13:00;642;274;368;Leicht bewölkt;6;5;0
13/02/2019;14:00;432;193;239;Leicht bewölkt;7;5;0
13/02/2019;15:00;572;273;299;Leicht bewölkt;7;6;0
13/02/2019;16:00;601;292;309;Leicht bewölkt;6;5;0
13/02/2019;17:00;741;317;424;Leicht bewölkt;5;4;0
13/02/2019;18:00;570;286;284;Leicht bewölkt;4;3;0
13/02/2019;19:00;392;171;221;Leicht bewölkt;4;3;0
13/02/2019;20:00;372;192;180;Leicht bewölkt;3;2;0
13/02/2019;21:00;198;80;118;Leicht bewölkt;2;2;0
13/02/2019;22:00;193;73;120;Leicht bewölkt;2;1;0
13/02/2019;23:00;114;42;72;Leicht bewölkt;1;1;0
14/02/2019;00:00;60;12;48;Leicht bewölkt;1;1;0
14/02/2019;01:00;24;6;18;Leicht bewölkt;1;1;0
14/02/2019;02:00;10;7;3;Leicht bewölkt;1;1;0
14/02/2019;03:00;4;1;3;Leicht bewölkt;1;1;0
14/02/2019;04:00;8;6;2;Leicht bewölkt;1;1;0
14/02/2019;05:00;25;17;8;Leicht bewölkt;1;1;0
14/02/2019;06:00;110;67;43;Leicht bewölkt;1;1;0
14/02/2019;07:00;697;387;310;Leicht bewölkt;2;2;0
14/02/2019;08:00;523;282;241;Leicht bewölkt;3;3;0
14/02/2019;09:00;461;282;179;Leicht bewölkt;4;4;0
14/02/2019;10:00;288;150;138;Leicht bewölkt;6;6;0
14/02/2019;11:00;393;173;220;Leicht bewölkt;7;7;0
14/02/2019;12:00;456;189;267;Leicht bewölkt;9;9;0
14/02/2019;13:00;596;249;347;Leicht bewölkt;9;9;0
14/02/2019;14:00;426;227;199;Leicht bewölkt;9;9;0
14/02/2019;15:00;657;319;338;Leicht bewölkt;9;9;0
14/02/2019;16:00;633;324;309;Leicht bewölkt;9;9;0
14/02/2019;17:00;702;313;389;Leicht bewölkt;8;8;0
14/02/2019;18:00;601;304;297;Leicht bewölkt;8;8;0
14/02/2019;19:00;355;166;189;Leicht bewölkt;7;7;0
14/02/2019;20:00;296;143;153;Leicht bewölkt;6;6;0
14/02/2019;21:00;177;83;94;Leicht bewölkt;5;5;0
14/02/2019;22:00;196;72;124;Leicht bewölkt;5;5;0
14/02/2019;23:00;109;36;73;Sonnig;5;5;0
15/02/2019;00:00;72;17;55;Sonnig;4;4;0
15/02/2019;01:00;41;5;36;Sonnig;4;4;0
15/02/2019;02:00;19;8;11;Sonnig;4;4;0
15/02/2019;03:00;6;4;2;Sonnig;4;4;0
15/02/2019;04:00;3;2;1;Sonnig;3;3;0
15/02/2019;05:00;28;20;8;Sonnig;3;3;0
15/02/2019;06:00;127;77;50;Sonnig;3;3;0
15/02/2019;07:00;628;389;239;Sonnig;4;4;0
15/02/2019;08:00;527;282;245;Sonnig;5;5;0
15/02/2019;09:00;426;272;154;Sonnig;6;6;0
15/02/2019;10:00;337;185;152;Sonnig;7;7;0
15/02/2019;11:00;428;204;224;Sonnig;9;9;0
15/02/2019;12:00;564;286;278;Sonnig;10;10;0
15/02/2019;13:00;691;233;458;Sonnig;11;10;0
15/02/2019;14:00;502;236;266;Sonnig;11;11;0
15/02/2019;15:00;543;233;310;Sonnig;12;11;0
15/02/2019;16:00;565;296;269;Sonnig;11;11;0
15/02/2019;17:00;600;300;300;Leicht bewölkt;11;11;0
15/02/2019;18:00;485;244;241;Leicht bewölkt;10;10;0
15/02/2019;19:00;430;219;211;Leicht bewölkt;9;9;0
15/02/2019;20:00;230;117;113;Leicht bewölkt;8;8;0
15/02/2019;21:00;158;86;72;Leicht bewölkt;7;7;0
15/02/2019;22:00;170;83;87;Leicht bewölkt;6;6;0
15/02/2019;23:00;164;64;100;Sonnig;6;6;0
16/02/2019;00:00;80;22;58;Sonnig;5;5;0
16/02/2019;01:00;69;13;56;Sonnig;5;5;0
16/02/2019;02:00;50;11;39;Sonnig;5;5;0
16/02/2019;03:00;63;12;51;Sonnig;5;5;0
16/02/2019;04:00;17;3;14;Sonnig;4;4;0
16/02/2019;05:00;20;9;11;Sonnig;4;3;0
16/02/2019;06:00;36;16;20;Sonnig;4;3;0
16/02/2019;07:00;57;31;26;Sonnig;5;4;0
16/02/2019;08:00;128;73;55;Sonnig;6;5;0
16/02/2019;09:00;196;118;78;Sonnig;7;7;0
16/02/2019;10:00;260;153;107;Sonnig;9;8;0
16/02/2019;11:00;332;167;165;Sonnig;10;10;0
16/02/2019;12:00;405;207;198;Sonnig;12;12;0
16/02/2019;13:00;376;188;188;Sonnig;13;13;0
16/02/2019;14:00;450;249;201;Sonnig;13;14;0
16/02/2019;15:00;396;180;216;Sonnig;14;14;0
16/02/2019;16:00;399;192;207;Sonnig;14;14;0
16/02/2019;17:00;414;196;218;Sonnig;13;13;0
16/02/2019;18:00;297;155;142;Sonnig;13;13;0
16/02/2019;19:00;307;193;114;Sonnig;11;11;0
16/02/2019;20:00;192;97;95;Sonnig;10;10;0
16/02/2019;21:00;144;54;90;Sonnig;8;8;0
16/02/2019;22:00;153;68;85;Sonnig;7;7;0
16/02/2019;23:00;133;34;99;Leicht bewölkt;6;5;0
17/02/2019;00:00;103;32;71;Leicht bewölkt;5;4;0
17/02/2019;01:00;67;16;51;Leicht bewölkt;4;3;0
17/02/2019;02:00;44;17;27;Leicht bewölkt;4;3;0
17/02/2019;03:00;32;7;25;Leicht bewölkt;3;2;0
17/02/2019;04:00;23;4;19;Leicht bewölkt;3;2;0
17/02/2019;05:00;14;11;3;Leicht bewölkt;2;1;0
17/02/2019;06:00;20;13;7;Leicht bewölkt;2;1;0
17/02/2019;07:00;22;15;7;Leicht bewölkt;3;3;0
17/02/2019;08:00;53;21;32;Leicht bewölkt;5;4;0
17/02/2019;09:00;124;57;67;Leicht bewölkt;6;6;0
17/02/2019;10:00;111;52;59;Leicht bewölkt;8;8;0
17/02/2019;11:00;170;65;105;Leicht bewölkt;10;9;0
17/02/2019;12:00;236;122;114;Leicht bewölkt;11;11;0
17/02/2019;13:00;268;109;159;Leicht bewölkt;12;12;0
17/02/2019;14:00;324;176;148;Leicht bewölkt;13;13;0
17/02/2019;15:00;329;171;158;Leicht bewölkt;13;13;0
17/02/2019;16:00;301;136;165;Leicht bewölkt;13;13;0
17/02/2019;17:00;327;155;172;Leicht bewölkt;12;12;0
17/02/2019;18:00;244;117;127;Leicht bewölkt;11;11;0
17/02/2019;19:00;175;93;82;Leicht bewölkt;10;10;0
17/02/2019;20:00;126;44;82;Sonnig;9;9;0
17/02/2019;21:00;85;28;57;Sonnig;8;7;0
17/02/2019;22:00;75;28;47;Sonnig;7;7;0
17/02/2019;23:00;38;16;22;Sonnig;7;6;0
18/02/2019;00:00;20;6;14;Sonnig;6;6;0
18/02/2019;01:00;13;11;2;Sonnig;6;6;0
18/02/2019;02:00;3;0;3;Sonnig;6;6;0
18/02/2019;03:00;4;3;1;Sonnig;5;5;0
18/02/2019;04:00;3;2;1;Sonnig;5;5;0
18/02/2019;05:00;36;27;9;Sonnig;5;5;0
18/02/2019;06:00;109;71;38;Sonnig;4;4;0
18/02/2019;07:00;709;412;297;Sonnig;5;5;0
18/02/2019;08:00;590;307;283;Sonnig;6;6;0
18/02/2019;09:00;411;245;166;Sonnig;8;8;0
18/02/2019;10:00;302;149;153;Sonnig;9;9;0
18/02/2019;11:00;333;157;176;Sonnig;11;11;0
18/02/2019;12:00;433;184;249;Sonnig;13;13;0
18/02/2019;13:00;607;247;360;Sonnig;13;13;0
18/02/2019;14:00;423;225;198;Sonnig;14;14;0
18/02/2019;15:00;710;353;357;Sonnig;15;15;0
18/02/2019;16:00;604;265;339;Sonnig;14;14;0
18/02/2019;17:00;721;325;396;Leicht bewölkt;13;13;0
18/02/2019;18:00;550;242;308;Leicht bewölkt;12;13;0
18/02/2019;19:00;452;220;232;Leicht bewölkt;11;12;0
18/02/2019;20:00;250;126;124;Leicht bewölkt;10;11;0
18/02/2019;21:00;160;77;83;Leicht bewölkt;10;10;0
18/02/2019;22:00;128;53;75;Leicht bewölkt;8;8;0
18/02/2019;23:00;69;24;45;Leicht bewölkt;7;6;0
19/02/2019;00:00;36;9;27;Leicht bewölkt;6;4;0
19/02/2019;01:00;20;14;6;Leicht bewölkt;5;3;0
19/02/2019;02:00;4;2;2;Leicht bewölkt;4;3;0
19/02/2019;03:00;4;2;2;Leicht bewölkt;4;2;0
19/02/2019;04:00;3;2;1;Leicht bewölkt;3;1;0
19/02/2019;05:00;27;17;10;Leicht bewölkt;3;1;0
19/02/2019;06:00;132;78;54;Leicht bewölkt;3;1;0
19/02/2019;07:00;699;432;267;Leicht bewölkt;4;2;0
19/02/2019;08:00;569;308;261;Leicht bewölkt;5;3;0
19/02/2019;09:00;443;240;203;Leicht bewölkt;6;4;0
19/02/2019;10:00;316;170;146;Leicht bewölkt;7;6;0
19/02/2019;11:00;361;175;186;Leicht bewölkt;8;7;0
19/02/2019;12:00;457;181;276;Leicht bewölkt;10;8;0
19/02/2019;13:00;632;264;368;Leicht bewölkt;10;9;0
19/02/2019;14:00;422;205;217;Leicht bewölkt;11;9;0
19/02/2019;15:00;691;348;343;Leicht bewölkt;11;10;0
19/02/2019;16:00;637;302;335;Leicht bewölkt;10;9;0
19/02/2019;17:00;741;334;407;Leicht bewölkt;9;8;0
19/02/2019;18:00;570;265;305;Leicht bewölkt;8;8;0
19/02/2019;19:00;475;214;261;Leicht bewölkt;7;7;0
19/02/2019;20:00;312;131;181;Leicht bewölkt;7;6;0
19/02/2019;21:00;185;64;121;Leicht bewölkt;6;5;0
19/02/2019;22:00;163;70;93;Leicht bewölkt;5;4;0
19/02/2019;23:00;137;48;89;Leicht bewölkt;5;4;0
20/02/2019;00:00;44;22;22;Leicht bewölkt;4;3;0
20/02/2019;01:00;25;10;15;Leicht bewölkt;4;3;0
20/02/2019;02:00;12;3;9;Bewölkt;4;3;0
20/02/2019;03:00;5;1;4;Bewölkt;4;4;0
20/02/2019;04:00;4;4;0;Bewölkt;4;3;0
20/02/2019;05:00;25;13;12;Bewölkt;3;3;0
20/02/2019;06:00;139;86;53;Bewölkt;3;3;0
20/02/2019;07:00;717;425;292;Bewölkt;4;4;0
20/02/2019;08:00;517;273;244;Leicht bewölkt;5;5;0
20/02/2019;09:00;436;264;172;Leicht bewölkt;6;6;0
20/02/2019;10:00;291;157;134;Leicht bewölkt;7;7;0
20/02/2019;11:00;389;184;205;Leicht bewölkt;9;8;0
20/02/2019;12:00;526;203;323;Leicht bewölkt;10;10;0
20/02/2019;13:00;597;259;338;Leicht bewölkt;10;10;0
20/02/2019;14:00;495;275;220;Leicht bewölkt;11;11;0
20/02/2019;15:00;546;283;263;Leicht bewölkt;11;11;0
20/02/2019;16:00;652;331;321;Leicht bewölkt;10;10;0
20/02/2019;17:00;721;310;411;Bewölkt;9;9;0
20/02/2019;18:00;581;259;322;Bewölkt;8;8;0
20/02/2019;19:00;432;192;240;Bewölkt;8;7;0
20/02/2019;20:00;291;154;137;Leicht bewölkt;7;6;0
20/02/2019;21:00;193;84;109;Leicht bewölkt;6;5;0
20/02/2019;22:00;173;87;86;Leicht bewölkt;5;4;0
20/02/2019;23:00;94;33;61;Leicht bewölkt;5;4;0
21/02/2019;00:00;72;17;55;Leicht bewölkt;4;3;0
21/02/2019;01:00;18;1;17;Leicht bewölkt;4;3;0
21/02/2019;02:00;8;5;3;Leicht bewölkt;4;3;0
21/02/2019;03:00;3;2;1;Leicht bewölkt;4;3;0
21/02/2019;04:00;3;3;0;Leicht bewölkt;3;2;0
21/02/2019;05:00;29;19;10;Leicht bewölkt;3;2;0
21/02/2019;06:00;136;83;53;Leicht bewölkt;3;2;0
21/02/2019;07:00;714;427;287;Leicht bewölkt;4;3;0
21/02/2019;08:00;520;291;229;Leicht bewölkt;5;5;0
21/02/2019;09:00;427;269;158;Leicht bewölkt;7;6;0
21/02/2019;10:00;312;159;153;Leicht bewölkt;8;7;0
21/02/2019;11:00;368;156;212;Leicht bewölkt;9;9;0
21/02/2019;12:00;425;174;251;Leicht bewölkt;11;10;0
21/02/2019;13:00;637;243;394;Leicht bewölkt;11;11;0
21/02/2019;14:00;460;243;217;Leicht bewölkt;12;12;0
21/02/2019;15:00;625;336;289;Leicht bewölkt;12;12;0
21/02/2019;16:00;681;312;369;Leicht bewölkt;11;11;0
21/02/2019;17:00;756;314;442;Leicht bewölkt;10;10;0
21/02/2019;18:00;677;313;364;Leicht bewölkt;10;10;0
21/02/2019;19:00;433;212;221;Leicht bewölkt;8;8;0
21/02/2019;20:00;271;132;139;Leicht bewölkt;7;7;0
21/02/2019;21:00;227;89;138;Leicht bewölkt;6;6;0
21/02/2019;22:00;179;56;123;Leicht bewölkt;6;6;0
21/02/2019;23:00;88;33;55;Leicht bewölkt;6;5;0
22/02/2019;00:00;60;24;36;Leicht bewölkt;6;5;0
22/02/2019;01:00;36;17;19;Leicht bewölkt;6;5;0
22/02/2019;02:00;11;4;7;Leicht bewölkt;6;5;0
22/02/2019;03:00;5;2;3;Leicht bewölkt;7;5;0
22/02/2019;04:00;4;4;0;Leicht bewölkt;7;6;0
22/02/2019;05:00;26;16;10;Stellenweiser Regenfall;7;6;0
22/02/2019;06:00;121;76;45;Stellenweiser Regenfall;7;6;0
22/02/2019;07:00;640;396;244;Stellenweiser Regenfall;8;7;0
22/02/2019;08:00;538;299;239;Stellenweiser Regenfall;8;8;0
22/02/2019;09:00;450;272;178;Stellenweiser Regenfall;8;8;0
22/02/2019;10:00;377;197;180;Stellenweiser Regenfall;9;8;0
22/02/2019;11:00;400;178;222;Stellenweiser Regenfall;9;9;0
22/02/2019;12:00;528;244;284;Stellenweiser Regenfall;9;9;0
22/02/2019;13:00;667;251;416;Stellenweiser Regenfall;9;9;0
22/02/2019;14:00;512;244;268;Leichter Regenschauer;10;9;0
22/02/2019;15:00;494;235;259;Leichter Regenschauer;10;9;0
22/02/2019;16:00;466;227;239;Leichter Regenschauer;9;7;0
22/02/2019;17:00;493;214;279;Stellenweiser Regenfall;8;6;0
22/02/2019;18:00;441;209;232;Stellenweiser Regenfall;7;5;0
22/02/2019;19:00;358;169;189;Stellenweiser Regenfall;7;4;0
22/02/2019;20:00;224;115;109;Leicht bewölkt;6;4;0
22/02/2019;21:00;181;94;87;Leicht bewölkt;6;3;0
22/02/2019;22:00;143;65;78;Leicht bewölkt;5;3;0
22/02/2019;23:00;98;26;72;Leicht bewölkt;5;2;0
23/02/2019;00:00;71;28;43;Leicht bewölkt;5;2;0
23/02/2019;01:00;73;25;48;Leicht bewölkt;4;1;0
23/02/2019;02:00;33;7;26;Leicht bewölkt;4;1;0
23/02/2019;03:00;26;6;20;Leicht bewölkt;4;0;0
23/02/2019;04:00;12;7;5;Leicht bewölkt;3;0;0
23/02/2019;05:00;20;14;6;Leicht bewölkt;3;-1;0
23/02/2019;06:00;26;17;9;Leicht bewölkt;3;-1;0
23/02/2019;07:00;57;28;29;Leicht bewölkt;3;-1;0
23/02/2019;08:00;146;90;56;Leicht bewölkt;3;0;0
23/02/2019;09:00;253;142;111;Leicht bewölkt;4;0;0
23/02/2019;10:00;309;157;152;Leicht bewölkt;5;1;0
23/02/2019;11:00;356;187;169;Sonnig;6;3;0
23/02/2019;12:00;429;205;224;Sonnig;7;4;0
23/02/2019;13:00;451;205;246;Sonnig;7;4;0
23/02/2019;14:00;427;214;213;Sonnig;8;4;0
23/02/2019;15:00;400;195;205;Sonnig;8;5;0
23/02/2019;16:00;392;190;202;Sonnig;7;3;0
23/02/2019;17:00;429;208;221;Leicht bewölkt;6;2;0
23/02/2019;18:00;316;137;179;Leicht bewölkt;4;0;0
23/02/2019;19:00;241;122;119;Leicht bewölkt;3;-1;0
23/02/2019;20:00;186;77;109;Bedeckt;3;-2;0
23/02/2019;21:00;142;71;71;Bedeckt;2;-3;0
23/02/2019;22:00;122;54;68;Bedeckt;1;-3;0
23/02/2019;23:00;120;66;54;Leicht bewölkt;1;-3;0
24/02/2019;00:00;103;37;66;Leicht bewölkt;1;-3;0
24/02/2019;01:00;65;37;28;Leicht bewölkt;1;-3;0
24/02/2019;02:00;56;15;41;Leicht bewölkt;1;-2;0
24/02/2019;03:00;36;13;23;Leicht bewölkt;1;-2;0
24/02/2019;04:00;11;8;3;Leicht bewölkt;1;-2;0
24/02/2019;05:00;14;7;7;Sonnig;1;-2;0
24/02/2019;06:00;20;15;5;Sonnig;1;-2;0
24/02/2019;07:00;22;9;13;Sonnig;2;-1;0
24/02/2019;08:00;61;39;22;Sonnig;3;1;0
24/02/2019;09:00;142;87;55;Sonnig;4;2;0
24/02/2019;10:00;138;77;61;Sonnig;5;4;0
24/02/2019;11:00;186;80;106;Sonnig;7;5;0
24/02/2019;12:00;259;113;146;Sonnig;8;7;0
24/02/2019;13:00;288;151;137;Sonnig;9;8;0
24/02/2019;14:00;302;151;151;Leicht bewölkt;10;9;0
24/02/2019;15:00;343;160;183;Leicht bewölkt;10;9;0
24/02/2019;16:00;270;113;157;Leicht bewölkt;10;9;0
24/02/2019;17:00;314;154;160;Leicht bewölkt;9;9;0
24/02/2019;18:00;193;87;106;Leicht bewölkt;9;9;0
24/02/2019;19:00;153;83;70;Leicht bewölkt;8;8;0
24/02/2019;20:00;129;69;60;Leicht bewölkt;8;8;0
24/02/2019;21:00;76;31;45;Leicht bewölkt;7;7;0
24/02/2019;22:00;66;29;37;Leicht bewölkt;6;5;0
24/02/2019;23:00;41;15;26;Leicht bewölkt;5;4;0
25/02/2019;00:00;24;6;18;Leicht bewölkt;4;2;0
25/02/2019;01:00;15;6;9;Leicht bewölkt;3;2;0
25/02/2019;02:00;6;2;4;Leicht bewölkt;3;1;0
25/02/2019;03:00;3;2;1;Leicht bewölkt;3;0;0
25/02/2019;04:00;5;5;0;Leicht bewölkt;3;0;0
25/02/2019;05:00;31;18;13;Leicht bewölkt;3;0;0
25/02/2019;06:00;130;77;53;Leicht bewölkt;3;0;0
25/02/2019;07:00;741;447;294;Leicht bewölkt;4;2;0
25/02/2019;08:00;530;288;242;Sonnig;5;3;0
25/02/2019;09:00;380;229;151;Sonnig;6;4;0
25/02/2019;10:00;289;132;157;Sonnig;7;6;0
25/02/2019;11:00;395;172;223;Sonnig;9;7;0
25/02/2019;12:00;431;185;246;Sonnig;11;9;0
25/02/2019;13:00;607;228;379;Sonnig;11;10;0
25/02/2019;14:00;426;206;220;Leicht bewölkt;12;10;0
25/02/2019;15:00;717;380;337;Leicht bewölkt;12;11;0
25/02/2019;16:00;618;290;328;Leicht bewölkt;12;11;0
25/02/2019;17:00;742;326;416;Leicht bewölkt;12;11;0
25/02/2019;18:00;585;283;302;Leicht bewölkt;11;11;0
25/02/2019;19:00;421;208;213;Leicht bewölkt;10;10;0
25/02/2019;20:00;298;134;164;Leicht bewölkt;9;9;0
25/02/2019;21:00;150;62;88;Leicht bewölkt;8;8;0
25/02/2019;22:00;171;83;88;Leicht bewölkt;7;7;0
25/02/2019;23:00;64;33;31;Leicht bewölkt;6;6;0
26/02/2019;00:00;45;12;33;Leicht bewölkt;5;4;0
26/02/2019;01:00;37;14;23;Leicht bewölkt;5;4;0
26/02/2019;02:00;10;4;6;Leicht bewölkt;4;4;0
26/02/2019;03:00;7;1;6;Leicht bewölkt;4;4;0
26/02/2019;04:00;3;3;0;Leicht bewölkt;4;4;0
26/02/2019;05:00;38;23;15;Leicht bewölkt;4;4;0
26/02/2019;06:00;141;88;53;Leicht bewölkt;4;4;0
26/02/2019;07:00;667;395;272;Leicht bewölkt;5;5;0
26/02/2019;08:00;612;336;276;Leicht bewölkt;6;6;0
26/02/2019;09:00;450;277;173;Leicht bewölkt;7;7;0
26/02/2019;10:00;313;156;157;Leicht bewölkt;9;9;0
26/02/2019;11:00;440;201;239;Leicht bewölkt;10;10;0
26/02/2019;12:00;491;199;292;Leicht bewölkt;12;12;0
26/02/2019;13:00;620;262;358;Leicht bewölkt;13;12;0
26/02/2019;14:00;469;254;215;Leicht bewölkt;13;13;0
26/02/2019;15:00;669;329;340;Leicht bewölkt;14;14;0
26/02/2019;16:00;687;322;365;Leicht bewölkt;13;13;0
26/02/2019;17:00;766;387;379;Leicht bewölkt;12;12;0
26/02/2019;18:00;527;254;273;Leicht bewölkt;12;12;0
26/02/2019;19:00;512;242;270;Leicht bewölkt;10;10;0
26/02/2019;20:00;273;110;163;Leicht bewölkt;9;9;0
26/02/2019;21:00;165;67;98;Leicht bewölkt;7;7;0
26/02/2019;22:00;164;58;106;Leicht bewölkt;7;6;0
26/02/2019;23:00;78;47;31;Leicht bewölkt;6;6;0
27/02/2019;00:00;45;15;30;Leicht bewölkt;5;5;0
27/02/2019;01:00;19;9;10;Leicht bewölkt;5;5;0
27/02/2019;02:00;8;4;4;Leicht bewölkt;5;5;0
27/02/2019;03:00;7;2;5;Leicht bewölkt;5;5;0
27/02/2019;04:00;7;4;3;Leicht bewölkt;5;5;0
27/02/2019;05:00;32;17;15;Leicht bewölkt;5;5;0
27/02/2019;06:00;141;85;56;Leicht bewölkt;5;5;0
27/02/2019;07:00;744;429;315;Leicht bewölkt;6;6;0
27/02/2019;08:00;562;337;225;Leicht bewölkt;7;7;0
27/02/2019;09:00;464;266;198;Leicht bewölkt;9;9;0
27/02/2019;10:00;335;166;169;Leicht bewölkt;10;10;0
27/02/2019;11:00;397;186;211;Leicht bewölkt;12;12;0
27/02/2019;12:00;499;230;269;Leicht bewölkt;14;14;0
27/02/2019;13:00;677;302;375;Leicht bewölkt;15;15;0
27/02/2019;14:00;527;265;262;Sonnig;15;15;0
27/02/2019;15:00;645;298;347;Sonnig;16;16;0
27/02/2019;16:00;695;348;347;Sonnig;15;15;0
27/02/2019;17:00;799;398;401;Sonnig;14;14;0
27/02/2019;18:00;609;285;324;Sonnig;13;13;0
27/02/2019;19:00;577;357;220;Sonnig;12;12;0
27/02/2019;20:00;336;134;202;Sonnig;11;11;0
27/02/2019;21:00;286;83;203;Sonnig;10;10;0
27/02/2019;22:00;213;87;126;Sonnig;9;9;0
27/02/2019;23:00;123;52;71;Sonnig;9;8;0
28/02/2019;00:00;60;11;49;Sonnig;8;8;0
28/02/2019;01:00;43;5;38;Sonnig;8;7;0
28/02/2019;02:00;8;3;5;Sonnig;8;7;0
28/02/2019;03:00;5;2;3;Sonnig;7;6;0
28/02/2019;04:00;11;7;4;Sonnig;7;5;0
28/02/2019;05:00;34;18;16;Sonnig;7;5;0
28/02/2019;06:00;131;72;59;Sonnig;6;5;0
28/02/2019;07:00;431;255;176;Sonnig;7;6;0
28/02/2019;08:00;404;185;219;Sonnig;8;7;0
28/02/2019;09:00;371;160;211;Sonnig;10;8;0
28/02/2019;10:00;381;233;148;Sonnig;11;9;0
28/02/2019;11:00;353;220;133;Sonnig;12;11;0
28/02/2019;12:00;400;243;157;Sonnig;14;12;0
28/02/2019;13:00;319;156;163;Sonnig;14;13;0
28/02/2019;14:00;356;189;167;Leicht bewölkt;15;14;0
28/02/2019;15:00;366;172;194;Leicht bewölkt;15;15;0
28/02/2019;16:00;332;151;181;Leicht bewölkt;15;14;0
28/02/2019;17:00;389;204;185;Leicht bewölkt;14;14;0
28/02/2019;18:00;338;212;126;Leicht bewölkt;14;14;0
28/02/2019;19:00;244;150;94;Leicht bewölkt;13;13;0
28/02/2019;20:00;244;81;163;Leicht bewölkt;12;12;0
28/02/2019;21:00;192;70;122;Leicht bewölkt;11;11;0
28/02/2019;22:00;157;40;117;Leicht bewölkt;10;10;0
28/02/2019;23:00;137;25;112;Leichter Regenschauer;9;8;0
01/03/2019;00:00;93;12;81;Leichter Regenschauer;8;7;0
01/03/2019;01:00;53;4;49;Leichter Regenschauer;8;6;0
01/03/2019;02:00;41;6;35;Stellenweiser leichter Regenfall;8;5;0
01/03/2019;03:00;25;4;21;Stellenweiser leichter Regenfall;8;5;0
01/03/2019;04:00;13;2;11;Stellenweiser leichter Regenfall;8;5;0
01/03/2019;05:00;31;15;16;Leichter Regenfall;8;5;0
01/03/2019;06:00;74;52;22;Leichter Regenfall;8;4;0
01/03/2019;07:00;170;84;86;Leichter Regenfall;8;4;0
01/03/2019;08:00;278;178;100;Nieselregen;8;4;0
01/03/2019;09:00;159;103;56;Nieselregen;8;4;0
01/03/2019;10:00;177;94;83;Nieselregen;7;4;0
01/03/2019;11:00;234;112;122;Mäßiger bis starker Regen mit Gewitter;7;4;1
01/03/2019;12:00;254;108;146;Mäßiger bis starker Regen mit Gewitter;7;4;1
01/03/2019;13:00;296;131;165;Mäßiger bis starker Regen mit Gewitter;7;4;0
01/03/2019;14:00;287;150;137;Mäßiger Regenfall;7;4;0
01/03/2019;15:00;275;125;150;Mäßiger Regenfall;7;4;1
01/03/2019;16:00;307;144;163;Mäßiger Regenfall;7;4;0
01/03/2019;17:00;322;135;187;Mäßiger Regenfall;7;4;0
01/03/2019;18:00;270;141;129;Mäßiger Regenfall;7;4;0
01/03/2019;19:00;221;108;113;Mäßiger Regenfall;6;4;0
01/03/2019;20:00;128;57;71;Leichter Regenfall;6;4;0
01/03/2019;21:00;117;46;71;Leichter Regenfall;6;3;0
01/03/2019;22:00;97;37;60;Leichter Regenfall;6;3;0
01/03/2019;23:00;58;19;39;Stellenweiser Regenfall;6;3;0
02/03/2019;00:00;37;9;28;Stellenweiser Regenfall;6;4;0
02/03/2019;01:00;22;8;14;Stellenweiser Regenfall;6;3;0
02/03/2019;02:00;16;7;9;Bedeckt;6;3;0
02/03/2019;03:00;12;2;10;Bedeckt;6;3;0
02/03/2019;04:00;6;3;3;Bedeckt;5;3;0
02/03/2019;05:00;17;11;6;Stellenweiser Regenfall;5;3;0
02/03/2019;06:00;22;12;10;Stellenweiser Regenfall;5;3;0
02/03/2019;07:00;44;26;18;Stellenweiser Regenfall;6;3;0
02/03/2019;08:00;123;65;58;Bedeckt;6;4;0
02/03/2019;09:00;197;103;94;Bedeckt;6;5;0
02/03/2019;10:00;295;179;116;Bedeckt;7;5;0
02/03/2019;11:00;321;183;138;Leicht bewölkt;8;6;0
02/03/2019;12:00;321;147;174;Leicht bewölkt;9;7;0
02/03/2019;13:00;272;144;128;Leicht bewölkt;9;7;0
02/03/2019;14:00;317;140;177;Bewölkt;9;8;0
02/03/2019;15:00;309;138;171;Bewölkt;10;8;0
02/03/2019;16:00;271;119;152;Bewölkt;9;7;0
02/03/2019;17:00;277;131;146;Bewölkt;8;7;0
02/03/2019;18:00;341;167;174;Bewölkt;7;6;0
02/03/2019;19:00;235;135;100;Bewölkt;6;5;0
02/03/2019;20:00;154;94;60;Leicht bewölkt;5;4;0
02/03/2019;21:00;119;65;54;Leicht bewölkt;4;4;0
02/03/2019;22:00;115;55;60;Leicht bewölkt;5;4;0
02/03/2019;23:00;86;39;47;Bedeckt;5;4;0
03/03/2019;00:00;75;24;51;Bedeckt;6;4;0
03/03/2019;01:00;77;15;62;Bedeckt;5;3;0
03/03/2019;02:00;47;4;43;Bedeckt;5;3;0
03/03/2019;03:00;69;8;61;Bedeckt;5;2;0
03/03/2019;04:00;15;3;12;Bedeckt;5;2;0
03/03/2019;05:00;18;7;11;Leicht bewölkt;4;1;0
03/03/2019;06:00;22;14;8;Leicht bewölkt;4;1;0
03/03/2019;07:00;15;8;7;Leicht bewölkt;5;2;0
03/03/2019;08:00;56;23;33;Leicht bewölkt;6;3;0
03/03/2019;09:00;119;60;59;Leicht bewölkt;7;4;0
03/03/2019;10:00;140;75;65;Leicht bewölkt;8;6;0
03/03/2019;11:00;215;120;95;Leicht bewölkt;10;7;0
03/03/2019;12:00;426;319;107;Leicht bewölkt;11;9;0
03/03/2019;13:00;285;214;71;Leicht bewölkt;11;10;0
03/03/2019;14:00;235;117;118;Leicht bewölkt;12;10;0
03/03/2019;15:00;313;104;209;Leicht bewölkt;12;11;0
03/03/2019;16:00;389;108;281;Leicht bewölkt;11;10;0
03/03/2019;17:00;263;105;158;Bewölkt;10;9;0
03/03/2019;18:00;187;74;113;Bewölkt;9;8;0
03/03/2019;19:00;157;77;80;Bewölkt;8;7;0
03/03/2019;20:00;115;60;55;Leicht bewölkt;7;6;0
03/03/2019;21:00;86;38;48;Leicht bewölkt;6;4;0
03/03/2019;22:00;63;21;42;Leicht bewölkt;6;4;0
03/03/2019;23:00;34;12;22;Leicht bewölkt;6;4;0
04/03/2019;00:00;22;11;11;Leicht bewölkt;6;4;0
04/03/2019;01:00;26;4;22;Leicht bewölkt;6;3;0
04/03/2019;02:00;8;0;8;Leicht bewölkt;5;3;0
04/03/2019;03:00;6;1;5;Leicht bewölkt;5;2;0
04/03/2019;04:00;4;4;0;Leicht bewölkt;5;2;0
04/03/2019;05:00;25;13;12;Leicht bewölkt;5;2;0
04/03/2019;06:00;101;74;27;Leicht bewölkt;4;2;0
04/03/2019;07:00;211;116;95;Leicht bewölkt;6;3;0
04/03/2019;08:00;328;173;155;Leicht bewölkt;7;4;0
04/03/2019;09:00;226;108;118;Leicht bewölkt;9;6;0
04/03/2019;10:00;218;126;92;Leicht bewölkt;9;6;0
04/03/2019;11:00;208;105;103;Leicht bewölkt;9;5;0
04/03/2019;12:00;206;87;119;Leicht bewölkt;9;5;0
04/03/2019;13:00;203;95;108;Leicht bewölkt;9;5;0
04/03/2019;14:00;177;93;84;Leichter Regenfall;9;5;0
04/03/2019;15:00;205;87;118;Leichter Regenfall;9;5;0
04/03/2019;16:00;265;130;135;Leichter Regenfall;8;4;0
04/03/2019;17:00;373;187;186;Stellenweiser leichter Regenfall;8;4;0
04/03/2019;18:00;289;160;129;Stellenweiser leichter Regenfall;8;3;0
04/03/2019;19:00;202;93;109;Stellenweiser leichter Regenfall;8;3;0
04/03/2019;20:00;163;95;68;Stellenweiser leichter Regenfall;7;2;0
04/03/2019;21:00;109;52;57;Stellenweiser leichter Regenfall;6;1;0
04/03/2019;22:00;66;31;35;Stellenweiser leichter Regenfall;6;1;0
04/03/2019;23:00;61;17;44;Bedeckt;6;1;0
05/03/2019;00:00;28;8;20;Bedeckt;5;1;0
05/03/2019;01:00;19;2;17;Bedeckt;5;0;0
05/03/2019;02:00;23;4;19;Leicht bewölkt;5;0;0
05/03/2019;03:00;13;2;11;Leicht bewölkt;5;0;0
05/03/2019;04:00;6;3;3;Leicht bewölkt;5;0;0
05/03/2019;05:00;31;18;13;Stellenweiser Regenfall;5;0;0
05/03/2019;06:00;109;79;30;Stellenweiser Regenfall;5;0;0
05/03/2019;07:00;245;130;115;Stellenweiser Regenfall;5;1;0
05/03/2019;08:00;404;202;202;Bedeckt;5;1;0
05/03/2019;09:00;378;236;142;Bedeckt;6;2;0
05/03/2019;10:00;259;144;115;Bedeckt;7;3;0
05/03/2019;11:00;301;150;151;Stellenweiser Regenfall;8;4;0
05/03/2019;12:00;317;142;175;Stellenweiser Regenfall;9;5;0
05/03/2019;13:00;318;138;180;Stellenweiser Regenfall;9;6;0
05/03/2019;14:00;314;164;150;Stellenweiser Regenfall;9;6;0
05/03/2019;15:00;329;143;186;Stellenweiser Regenfall;10;7;0
05/03/2019;16:00;428;207;221;Stellenweiser Regenfall;9;7;0
05/03/2019;17:00;512;257;255;Stellenweiser Regenfall;9;6;0
05/03/2019;18:00;464;227;237;Stellenweiser Regenfall;8;6;0
05/03/2019;19:00;318;137;181;Stellenweiser Regenfall;7;5;0
05/03/2019;20:00;197;72;125;Leicht bewölkt;7;4;0
05/03/2019;21:00;138;56;82;Leicht bewölkt;6;4;0
05/03/2019;22:00;103;43;60;Leicht bewölkt;5;3;0
05/03/2019;23:00;63;15;48;Leicht bewölkt;5;3;0
06/03/2019;00:00;33;10;23;Leicht bewölkt;4;2;0
06/03/2019;01:00;13;7;6;Leicht bewölkt;4;2;0
06/03/2019;02:00;5;1;4;Leicht bewölkt;4;2;0
06/03/2019;03:00;5;2;3;Leicht bewölkt;3;2;0
06/03/2019;04:00;3;3;0;Leicht bewölkt;3;1;0
06/03/2019;05:00;39;19;20;Leicht bewölkt;3;1;0
06/03/2019;06:00;123;77;46;Leicht bewölkt;2;1;0
06/03/2019;07:00;287;148;139;Leicht bewölkt;4;2;0
06/03/2019;08:00;462;279;183;Leicht bewölkt;5;4;0
06/03/2019;09:00;353;198;155;Leicht bewölkt;7;6;0
06/03/2019;10:00;301;152;149;Leicht bewölkt;9;8;0
06/03/2019;11:00;291;143;148;Leicht bewölkt;10;10;0
06/03/2019;12:00;339;157;182;Leicht bewölkt;12;12;0
06/03/2019;13:00;338;162;176;Leicht bewölkt;13;13;0
06/03/2019;14:00;373;178;195;Bedeckt;14;13;0
06/03/2019;15:00;392;190;202;Bedeckt;15;14;0
06/03/2019;16:00;493;233;260;Bedeckt;14;14;0
06/03/2019;17:00;550;257;293;Leicht bewölkt;13;13;0
06/03/2019;18:00;499;237;262;Leicht bewölkt;13;13;0
06/03/2019;19:00;342;154;188;Leicht bewölkt;12;11;0
06/03/2019;20:00;213;91;122;Bedeckt;10;10;0
06/03/2019;21:00;182;67;115;Bedeckt;9;9;0
06/03/2019;22:00;134;62;72;Bedeckt;8;8;0
06/03/2019;23:00;83;24;59;Bewölkt;8;7;0
07/03/2019;00:00;44;11;33;Bewölkt;7;6;0
07/03/2019;01:00;13;3;10;Bewölkt;6;5;0
07/03/2019;02:00;7;4;3;Leicht bewölkt;6;5;0
07/03/2019;03:00;8;3;5;Leicht bewölkt;6;5;0
07/03/2019;04:00;5;2;3;Leicht bewölkt;6;4;0
07/03/2019;05:00;38;25;13;Leicht bewölkt;5;3;0
07/03/2019;06:00;126;87;39;Leicht bewölkt;5;3;0
07/03/2019;07:00;253;135;118;Leicht bewölkt;5;3;0
07/03/2019;08:00;341;193;148;Leicht bewölkt;6;3;0
07/03/2019;09:00;226;137;89;Leicht bewölkt;6;4;0
07/03/2019;10:00;191;112;79;Leicht bewölkt;7;4;0
07/03/2019;11:00;219;116;103;Mäßiger Regenfall;7;5;0
07/03/2019;12:00;250;121;129;Mäßiger Regenfall;8;5;1
07/03/2019;13:00;311;150;161;Mäßiger Regenfall;8;6;0
07/03/2019;14:00;295;132;163;Mäßiger Regenfall;8;6;0
07/03/2019;15:00;328;179;149;Mäßiger Regenfall;9;7;0
07/03/2019;16:00;405;200;205;Mäßiger Regenfall;8;6;0
07/03/2019;17:00;491;241;250;Stellenweiser leichter Regenfall;8;5;0
07/03/2019;18:00;443;192;251;Stellenweiser leichter Regenfall;7;4;0
07/03/2019;19:00;346;156;190;Stellenweiser leichter Regenfall;7;4;0
07/03/2019;20:00;189;80;109;Stellenweiser Regenfall;6;3;0
07/03/2019;21:00;118;52;66;Stellenweiser Regenfall;6;3;0
07/03/2019;22:00;128;37;91;Stellenweiser Regenfall;6;3;0
07/03/2019;23:00;101;25;76;Leicht bewölkt;6;3;0
08/03/2019;00:00;42;13;29;Leicht bewölkt;6;3;0
08/03/2019;01:00;30;11;19;Leicht bewölkt;5;2;0
08/03/2019;02:00;10;4;6;Bedeckt;5;2;0
08/03/2019;03:00;1;0;1;Bedeckt;5;2;0
08/03/2019;04:00;5;3;2;Bedeckt;5;2;0
08/03/2019;05:00;36;21;15;Leicht bewölkt;5;2;0
08/03/2019;06:00;111;71;40;Leicht bewölkt;5;2;0
08/03/2019;07:00;260;121;139;Leicht bewölkt;6;2;0
08/03/2019;08:00;416;236;180;Stellenweiser Regenfall;6;3;0
08/03/2019;09:00;374;236;138;Stellenweiser Regenfall;6;3;0
08/03/2019;10:00;316;176;140;Stellenweiser Regenfall;7;3;0
08/03/2019;11:00;359;197;162;Leichter Regenfall;7;4;0
08/03/2019;12:00;347;147;200;Leichter Regenfall;8;4;0
08/03/2019;13:00;403;185;218;Leichter Regenfall;8;5;0
08/03/2019;14:00;452;220;232;Stellenweiser leichter Regenfall;8;6;0
08/03/2019;15:00;399;205;194;Stellenweiser leichter Regenfall;9;6;0
08/03/2019;16:00;456;214;242;Stellenweiser leichter Regenfall;8;5;0
08/03/2019;17:00;420;179;241;Stellenweiser Regenfall;7;5;0
08/03/2019;18:00;422;184;238;Stellenweiser Regenfall;7;4;0
08/03/2019;19:00;341;187;154;Stellenweiser Regenfall;6;3;0
08/03/2019;20:00;206;110;96;Leicht bewölkt;5;3;0
08/03/2019;21:00;174;94;80;Leicht bewölkt;4;2;0
08/03/2019;22:00;126;32;94;Leicht bewölkt;4;2;0
08/03/2019;23:00;118;33;85;Leicht bewölkt;4;2;0
09/03/2019;00:00;85;25;60;Leicht bewölkt;4;2;0
09/03/2019;01:00;50;18;32;Leicht bewölkt;5;2;0
09/03/2019;02:00;32;15;17;Leicht bewölkt;5;2;0
09/03/2019;03:00;18;5;13;Leicht bewölkt;6;3;0
09/03/2019;04:00;5;3;2;Leicht bewölkt;6;3;0
09/03/2019;05:00;26;16;10;Stellenweiser Regenfall;6;3;0
09/03/2019;06:00;37;22;15;Stellenweiser Regenfall;6;3;0
09/03/2019;07:00;36;19;17;Stellenweiser Regenfall;7;3;0
09/03/2019;08:00;90;53;37;Bedeckt;7;4;0
09/03/2019;09:00;197;132;65;Bedeckt;7;4;0
09/03/2019;10:00;247;130;117;Bedeckt;8;5;0
09/03/2019;11:00;292;157;135;Nieselregen;8;5;0
09/03/2019;12:00;290;136;154;Nieselregen;9;6;0
09/03/2019;13:00;300;145;155;Nieselregen;9;6;0
09/03/2019;14:00;326;175;151;Stellenweiser Regenfall;9;7;0
09/03/2019;15:00;297;149;148;Stellenweiser Regenfall;9;7;0
09/03/2019;16:00;248;110;138;Stellenweiser Regenfall;9;6;0
09/03/2019;17:00;261;122;139;Leichter Regenfall;9;6;0
09/03/2019;18:00;205;94;111;Leichter Regenfall;9;6;1
09/03/2019;19:00;199;116;83;Leichter Regenfall;8;6;0
09/03/2019;20:00;169;62;107;Mäßiger Regenfall;8;6;0
09/03/2019;21:00;152;63;89;Mäßiger Regenfall;8;6;0
09/03/2019;22:00;113;38;75;Mäßiger Regenfall;8;7;0
09/03/2019;23:00;96;32;64;Stellenweiser Regenfall;8;7;0
10/03/2019;00:00;89;20;69;Stellenweiser Regenfall;8;7;0
10/03/2019;01:00;61;25;36;Stellenweiser Regenfall;8;6;0
10/03/2019;02:00;48;22;26;Bedeckt;8;6;0
10/03/2019;03:00;34;14;20;Bedeckt;8;5;0
10/03/2019;04:00;12;5;7;Bedeckt;7;5;0
10/03/2019;05:00;11;6;5;Leichter Regenfall;7;5;0
10/03/2019;06:00;21;18;3;Leichter Regenfall;7;5;0
10/03/2019;07:00;22;13;9;Leichter Regenfall;8;5;0
10/03/2019;08:00;40;29;11;Mäßiger Regenfall;9;6;0
10/03/2019;09:00;49;28;21;Mäßiger Regenfall;10;6;0
10/03/2019;10:00;35;20;15;Mäßiger Regenfall;10;7;0
10/03/2019;11:00;74;31;43;Leichter Regenfall;11;7;0
10/03/2019;12:00;69;32;37;Leichter Regenfall;11;8;0
10/03/2019;13:00;113;40;73;Leichter Regenfall;11;8;0
10/03/2019;14:00;114;53;61;Bedeckt;11;8;0
10/03/2019;15:00;97;40;57;Bedeckt;12;8;0
10/03/2019;16:00;141;83;58;Bedeckt;11;8;0
10/03/2019;17:00;118;68;50;Leichter Regenschauer;11;7;0
10/03/2019;18:00;134;72;62;Leichter Regenschauer;10;7;0
10/03/2019;19:00;114;56;58;Leichter Regenschauer;9;6;0
10/03/2019;20:00;77;31;46;Leicht bewölkt;9;5;0
10/03/2019;21:00;66;28;38;Leicht bewölkt;8;4;0
10/03/2019;22:00;52;19;33;Leicht bewölkt;7;2;0
10/03/2019;23:00;32;15;17;Leichter Regenschauer;6;1;0
11/03/2019;00:00;11;5;6;Leichter Regenschauer;5;0;0
11/03/2019;01:00;7;7;0;Leichter Regenschauer;5;0;0
11/03/2019;02:00;6;1;5;Stellenweiser Eisregen;4;0;0
11/03/2019;03:00;1;1;0;Stellenweiser Eisregen;4;-1;0
11/03/2019;04:00;5;4;1;Stellenweiser Eisregen;4;-1;0
11/03/2019;05:00;24;15;9;Leicht bewölkt;4;-1;0
11/03/2019;06:00;113;73;40;Leicht bewölkt;4;-1;0
11/03/2019;07:00;715;458;257;Leicht bewölkt;4;-1;0
11/03/2019;08:00;501;306;195;Bewölkt;4;-1;0
11/03/2019;09:00;252;143;109;Bewölkt;4;-2;0
11/03/2019;10:00;227;121;106;Bewölkt;4;-1;0
11/03/2019;11:00;243;105;138;Leichter Eisregen;4;-1;0
11/03/2019;12:00;290;123;167;Leichter Eisregen;4;-1;0
11/03/2019;13:00;474;175;299;Leichter Eisregen;4;-1;0
11/03/2019;14:00;289;132;157;Leichter Eisregen;4;-1;0
11/03/2019;15:00;536;268;268;Leichter Eisregen;4;-1;0
11/03/2019;16:00;437;191;246;Leichter Eisregen;4;-1;0
11/03/2019;17:00;546;244;302;Leichte Eisregen;3;-2;0
11/03/2019;18:00;432;210;222;Leichte Eisregen;2;-2;0
11/03/2019;19:00;311;149;162;Leichte Eisregen;2;-3;0
11/03/2019;20:00;212;107;105;Mäßige bis starke Schneefälle;2;-3;0
11/03/2019;21:00;157;60;97;Mäßige bis starke Schneefälle;1;-4;0
11/03/2019;22:00;107;46;61;Mäßige bis starke Schneefälle;1;-4;0
11/03/2019;23:00;54;15;39;Leichte Schneeschauer;1;-4;0
12/03/2019;00:00;25;10;15;Leichte Schneeschauer;1;-4;0
12/03/2019;01:00;3;1;2;Leichte Schneeschauer;1;-4;0
12/03/2019;02:00;2;1;1;Bewölkt;1;-4;0
12/03/2019;03:00;8;2;6;Bewölkt;1;-4;0
12/03/2019;04:00;14;11;3;Bewölkt;1;-3;0
12/03/2019;05:00;25;17;8;Leichte Schneeschauer;1;-3;0
12/03/2019;06:00;131;85;46;Leichte Schneeschauer;1;-3;0
12/03/2019;07:00;711;448;263;Leichte Schneeschauer;1;-2;0
12/03/2019;08:00;590;319;271;Leicht bewölkt;2;-1;0
12/03/2019;09:00;442;270;172;Leicht bewölkt;3;0;0
12/03/2019;10:00;298;153;145;Leicht bewölkt;4;2;0
12/03/2019;11:00;366;170;196;Leicht bewölkt;6;3;0
12/03/2019;12:00;466;203;263;Leicht bewölkt;7;5;0
12/03/2019;13:00;628;237;391;Leicht bewölkt;8;6;0
12/03/2019;14:00;423;204;219;Bewölkt;9;7;0
12/03/2019;15:00;693;347;346;Bewölkt;10;8;0
12/03/2019;16:00;615;292;323;Bewölkt;9;8;0
12/03/2019;17:00;740;349;391;Leicht bewölkt;9;8;0
12/03/2019;18:00;615;275;340;Leicht bewölkt;8;8;0
12/03/2019;19:00;470;238;232;Leicht bewölkt;7;6;0
12/03/2019;20:00;237;107;130;Leicht bewölkt;6;4;0
12/03/2019;21:00;193;74;119;Leicht bewölkt;5;3;0
12/03/2019;22:00;171;45;126;Leicht bewölkt;4;2;0
12/03/2019;23:00;98;36;62;Leicht bewölkt;4;1;0
13/03/2019;00:00;31;9;22;Leicht bewölkt;4;1;0
13/03/2019;01:00;16;8;8;Leicht bewölkt;4;1;0
13/03/2019;02:00;3;2;1;Bedeckt;5;1;0
13/03/2019;03:00;5;5;0;Bedeckt;5;2;1
13/03/2019;04:00;4;3;1;Bedeckt;5;1;0
13/03/2019;05:00;30;18;12;Mäßiger Regenfall;5;1;1
13/03/2019;06:00;106;67;39;Mäßiger Regenfall;5;0;1
13/03/2019;07:00;776;459;317;Mäßiger Regenfall;4;0;0
13/03/2019;08:00;557;333;224;Mäßiger bis starker Eisregen;4;0;0
13/03/2019;09:00;381;243;138;Mäßiger bis starker Eisregen;4;-1;0
13/03/2019;10:00;251;142;109;Mäßiger bis starker Eisregen;5;0;0
13/03/2019;11:00;312;159;153;Leichte Eisregen;6;1;0
13/03/2019;12:00;433;220;213;Leichte Eisregen;6;2;0
13/03/2019;13:00;612;210;402;Leichte Eisregen;7;2;0
13/03/2019;14:00;418;185;233;Leicht bewölkt;7;3;0
13/03/2019;15:00;587;271;316;Leicht bewölkt;7;3;0
13/03/2019;16:00;527;267;260;Leicht bewölkt;7;2;0
13/03/2019;17:00;630;287;343;Stellenweiser Regenfall;6;2;0
13/03/2019;18:00;521;240;281;Stellenweiser Regenfall;5;1;0
13/03/2019;19:00;375;188;187;Stellenweiser Regenfall;5;1;0
13/03/2019;20:00;340;172;168;Leichter Regenschauer;5;0;0
13/03/2019;21:00;171;75;96;Leichter Regenschauer;4;0;0
13/03/2019;22:00;141;50;91;Leichter Regenschauer;4;0;0
13/03/2019;23:00;147;49;98;Mäßiger bis starker Regen mit Gewitter;4;0;0
14/03/2019;00:00;50;15;35;Mäßiger bis starker Regen mit Gewitter;4;0;0
14/03/2019;01:00;11;2;9;Mäßiger bis starker Regen mit Gewitter;4;0;0
14/03/2019;02:00;8;2;6;Leichter Regenfall;4;0;0
14/03/2019;03:00;7;3;4;Leichter Regenfall;4;-1;0
14/03/2019;04:00;4;3;1;Leichter Regenfall;4;-1;0
14/03/2019;05:00;28;18;10;Leichter Regenfall;4;-1;0
14/03/2019;06:00;112;67;45;Leichter Regenfall;4;-1;0
14/03/2019;07:00;685;420;265;Leichter Regenfall;4;-1;0
14/03/2019;08:00;508;294;214;Leichter Eisregen;4;-1;0
14/03/2019;09:00;342;201;141;Leichter Eisregen;4;-1;0
14/03/2019;10:00;238;131;107;Leichter Eisregen;5;0;0
14/03/2019;11:00;269;119;150;Nieselregen;5;0;0
14/03/2019;12:00;354;159;195;Nieselregen;5;0;0
14/03/2019;13:00;445;155;290;Nieselregen;5;1;0
14/03/2019;14:00;257;118;139;Stellenweiser Regenfall;5;1;0
14/03/2019;15:00;430;191;239;Stellenweiser Regenfall;6;1;0
14/03/2019;16:00;315;147;168;Stellenweiser Regenfall;5;1;0
14/03/2019;17:00;445;195;250;Mäßiger Regenfall;4;1;0
14/03/2019;18:00;358;160;198;Mäßiger Regenfall;3;1;0
14/03/2019;19:00;224;105;119;Mäßiger Regenfall;2;1;0
14/03/2019;20:00;149;64;85;Bedeckt;1;0;0
14/03/2019;21:00;103;52;51;Bedeckt;0;0;0
14/03/2019;22:00;112;39;73;Bedeckt;1;0;0
14/03/2019;23:00;50;20;30;Leichter Regenfall;3;1;0
15/03/2019;00:00;25;9;16;Leichter Regenfall;4;2;0
15/03/2019;01:00;10;4;6;Leichter Regenfall;5;2;0
15/03/2019;02:00;9;5;4;Bedeckt;6;2;0
15/03/2019;03:00;5;2;3;Bedeckt;6;3;0
15/03/2019;04:00;3;1;2;Bedeckt;6;3;0
15/03/2019;05:00;30;23;7;Leichter Regenschauer;6;3;0
15/03/2019;06:00;109;63;46;Leichter Regenschauer;6;3;0
15/03/2019;07:00;553;347;206;Leichter Regenschauer;6;3;0
15/03/2019;08:00;389;230;159;Leichter Regenschauer;7;3;1
15/03/2019;09:00;289;170;119;Leichter Regenschauer;7;3;1
15/03/2019;10:00;196;105;91;Leichter Regenschauer;8;4;0
15/03/2019;11:00;220;107;113;Mäßiger Regenfall;8;4;1
15/03/2019;12:00;349;146;203;Mäßiger Regenfall;9;5;1
15/03/2019;13:00;510;167;343;Mäßiger Regenfall;9;5;1
15/03/2019;14:00;309;146;163;Starker Regenfall;9;5;1
15/03/2019;15:00;353;156;197;Starker Regenfall;9;6;1
15/03/2019;16:00;332;135;197;Starker Regenfall;9;6;0
15/03/2019;17:00;364;176;188;Mäßiger Regenfall;9;6;1
15/03/2019;18:00;279;139;140;Mäßiger Regenfall;9;6;1
15/03/2019;19:00;248;121;127;Mäßiger Regenfall;9;6;0
15/03/2019;20:00;189;102;87;Mäßiger Regenfall;9;6;0
15/03/2019;21:00;150;70;80;Mäßiger Regenfall;9;6;0
15/03/2019;22:00;119;42;77;Mäßiger Regenfall;9;6;0
15/03/2019;23:00;95;31;64;Leichter Regenfall;9;5;0
16/03/2019;00:00;63;21;42;Leichter Regenfall;9;5;0
16/03/2019;01:00;56;15;41;Leichter Regenfall;9;5;0
16/03/2019;02:00;52;19;33;Bewölkt;9;5;0
16/03/2019;03:00;16;8;8;Bewölkt;9;5;0
16/03/2019;04:00;25;12;13;Bewölkt;8;5;0
16/03/2019;05:00;15;11;4;Stellenweiser Nieselregen;8;5;0
16/03/2019;06:00;26;15;11;Stellenweiser Nieselregen;8;5;0
16/03/2019;07:00;57;32;25;Stellenweiser Nieselregen;8;5;0
16/03/2019;08:00;142;81;61;Leicht bewölkt;9;6;0
16/03/2019;09:00;269;147;122;Leicht bewölkt;9;6;0
16/03/2019;10:00;324;182;142;Leicht bewölkt;10;7;0
16/03/2019;11:00;398;221;177;Leicht bewölkt;11;9;0
16/03/2019;12:00;451;256;195;Leicht bewölkt;12;10;0
16/03/2019;13:00;385;209;176;Leicht bewölkt;13;11;0
16/03/2019;14:00;411;188;223;Sonnig;13;12;0
16/03/2019;15:00;427;208;219;Sonnig;14;13;0
16/03/2019;16:00;486;241;245;Sonnig;14;13;0
16/03/2019;17:00;452;230;222;Sonnig;13;13;0
16/03/2019;18:00;401;179;222;Sonnig;13;13;0
16/03/2019;19:00;263;145;118;Sonnig;13;12;0
16/03/2019;20:00;209;97;112;Sonnig;12;12;0
16/03/2019;21:00;158;82;76;Sonnig;11;11;0
16/03/2019;22:00;145;54;91;Sonnig;10;9;0
16/03/2019;23:00;101;28;73;Sonnig;8;7;0
17/03/2019;00:00;97;25;72;Sonnig;7;5;0
17/03/2019;01:00;79;30;49;Sonnig;6;4;0
17/03/2019;02:00;43;18;25;Leicht bewölkt;5;3;0
17/03/2019;03:00;27;14;13;Leicht bewölkt;4;3;0
17/03/2019;04:00;21;7;14;Leicht bewölkt;5;3;0
17/03/2019;05:00;21;14;7;Leicht bewölkt;5;3;0
17/03/2019;06:00;21;12;9;Leicht bewölkt;5;3;0
17/03/2019;07:00;25;10;15;Leicht bewölkt;7;5;0
17/03/2019;08:00;68;28;40;Sonnig;9;7;0
17/03/2019;09:00;166;94;72;Sonnig;11;9;0
17/03/2019;10:00;220;106;114;Sonnig;12;11;0
17/03/2019;11:00;290;134;156;Leicht bewölkt;14;13;0
17/03/2019;12:00;259;121;138;Leicht bewölkt;15;15;0
17/03/2019;13:00;248;115;133;Leicht bewölkt;14;14;0
17/03/2019;14:00;277;138;139;Leicht bewölkt;13;12;0
17/03/2019;15:00;266;133;133;Leicht bewölkt;13;11;0
17/03/2019;16:00;228;113;115;Leicht bewölkt;11;9;0
17/03/2019;17:00;180;91;89;Stellenweiser leichter Regenfall;9;7;0
17/03/2019;18:00;159;86;73;Stellenweiser leichter Regenfall;8;5;0
17/03/2019;19:00;116;66;50;Stellenweiser leichter Regenfall;7;4;0
17/03/2019;20:00;97;38;59;Mäßiger Regenfall;6;3;0
17/03/2019;21:00;63;26;37;Mäßiger Regenfall;6;2;0
17/03/2019;22:00;74;30;44;Mäßiger Regenfall;5;1;0
17/03/2019;23:00;30;11;19;Mäßiger Regenfall;5;1;0
18/03/2019;00:00;15;8;7;Mäßiger Regenfall;4;0;1
18/03/2019;01:00;7;1;6;Mäßiger Regenfall;4;0;0
18/03/2019;02:00;5;3;2;Mäßiger bis starker Eisregen;4;0;0
18/03/2019;03:00;2;1;1;Mäßiger bis starker Eisregen;3;-1;0
18/03/2019;04:00;6;4;2;Mäßiger bis starker Eisregen;3;-1;0
18/03/2019;05:00;40;25;15;Starker Schneefall;3;-1;0
18/03/2019;06:00;128;83;45;Starker Schneefall;3;-1;0
18/03/2019;07:00;699;442;257;Starker Schneefall;3;0;0
18/03/2019;08:00;594;353;241;Starker Schneefall;3;0;0
18/03/2019;09:00;487;314;173;Starker Schneefall;4;0;0
18/03/2019;10:00;291;169;122;Starker Schneefall;4;1;0
18/03/2019;11:00;424;221;203;Leichte Eisregen;5;2;0
18/03/2019;12:00;436;176;260;Leichte Eisregen;6;3;0
18/03/2019;13:00;673;258;415;Leichte Eisregen;6;3;0
18/03/2019;14:00;472;208;264;Leicht bewölkt;6;4;0
18/03/2019;15:00;657;319;338;Leicht bewölkt;7;4;0
18/03/2019;16:00;577;273;304;Leicht bewölkt;6;4;0
18/03/2019;17:00;694;302;392;Stellenweiser Regenfall;5;3;0
18/03/2019;18:00;587;254;333;Stellenweiser Regenfall;4;3;0
18/03/2019;19:00;451;214;237;Stellenweiser Regenfall;3;2;0
18/03/2019;20:00;248;113;135;Stellenweiser Regenfall;2;2;0
18/03/2019;21:00;155;61;94;Stellenweiser Regenfall;2;1;0
18/03/2019;22:00;132;40;92;Stellenweiser Regenfall;1;1;0
18/03/2019;23:00;83;29;54;Stellenweiser Regenfall;1;0;0
19/03/2019;00:00;36;10;26;Stellenweiser Regenfall;0;0;0
19/03/2019;01:00;23;8;15;Stellenweiser Regenfall;0;0;0
19/03/2019;02:00;13;8;5;Mäßige bis starke Schneefälle;0;0;0
19/03/2019;03:00;5;4;1;Mäßige bis starke Schneefälle;0;0;0
19/03/2019;04:00;11;9;2;Mäßige bis starke Schneefälle;0;0;0
19/03/2019;05:00;31;22;9;Leicht bewölkt;0;0;0
19/03/2019;06:00;148;104;44;Leicht bewölkt;0;0;0
19/03/2019;07:00;904;629;275;Leicht bewölkt;2;2;0
19/03/2019;08:00;636;337;299;Leicht bewölkt;3;3;0
19/03/2019;09:00;602;384;218;Leicht bewölkt;4;4;0
19/03/2019;10:00;316;162;154;Leicht bewölkt;5;5;0
19/03/2019;11:00;514;255;259;Stellenweiser Regenfall;7;6;0
19/03/2019;12:00;507;195;312;Stellenweiser Regenfall;8;7;0
19/03/2019;13:00;755;316;439;Stellenweiser Regenfall;8;7;0
19/03/2019;14:00;478;240;238;Stellenweiser Regenfall;8;7;0
19/03/2019;15:00;785;364;421;Stellenweiser Regenfall;8;7;0
19/03/2019;16:00;638;270;368;Stellenweiser Regenfall;7;5;0
19/03/2019;17:00;887;383;504;Stellenweiser Regenfall;6;4;0
19/03/2019;18:00;625;278;347;Stellenweiser Regenfall;5;3;0
19/03/2019;19:00;547;255;292;Stellenweiser Regenfall;4;1;0
19/03/2019;20:00;279;121;158;Stellenweiser Regenfall;3;0;0
19/03/2019;21:00;223;66;157;Stellenweiser Regenfall;2;-1;0
19/03/2019;22:00;240;83;157;Stellenweiser Regenfall;1;-1;0
19/03/2019;23:00;76;25;51;Leicht bewölkt;1;-2;0
20/03/2019;00:00;43;15;28;Leicht bewölkt;0;-2;0
20/03/2019;01:00;33;9;24;Leicht bewölkt;1;-1;0
20/03/2019;02:00;4;1;3;Leicht bewölkt;1;-1;0
20/03/2019;03:00;5;1;4;Leicht bewölkt;1;0;0
20/03/2019;04:00;8;5;3;Leicht bewölkt;1;0;0
20/03/2019;05:00;37;22;15;Sonnig;1;1;0
20/03/2019;06:00;148;94;54;Sonnig;1;1;0
20/03/2019;07:00;1084;736;348;Sonnig;3;2;0
20/03/2019;08:00;621;400;221;Sonnig;4;3;0
20/03/2019;09:00;550;363;187;Sonnig;5;4;0
20/03/2019;10:00;326;151;175;Sonnig;6;5;0
20/03/2019;11:00;500;183;317;Sonnig;7;6;0
20/03/2019;12:00;552;232;320;Sonnig;9;7;0
20/03/2019;13:00;875;449;426;Sonnig;9;7;0
20/03/2019;14:00;535;244;291;Leicht bewölkt;9;7;0
20/03/2019;15:00;683;313;370;Leicht bewölkt;10;8;0
20/03/2019;16:00;657;284;373;Leicht bewölkt;9;8;0
20/03/2019;17:00;940;383;557;Leicht bewölkt;9;8;0
20/03/2019;18:00;706;334;372;Leicht bewölkt;9;8;0
20/03/2019;19:00;514;233;281;Leicht bewölkt;8;7;0
20/03/2019;20:00;320;132;188;Leicht bewölkt;7;7;0
20/03/2019;21:00;245;111;134;Leicht bewölkt;7;7;0
20/03/2019;22:00;189;75;114;Leicht bewölkt;5;5;0
20/03/2019;23:00;101;42;59;Leicht bewölkt;4;3;0
21/03/2019;00:00;59;17;42;Leicht bewölkt;3;2;0
21/03/2019;01:00;31;6;25;Leicht bewölkt;2;1;0
21/03/2019;02:00;16;9;7;Sonnig;2;-1;0
21/03/2019;03:00;10;7;3;Sonnig;1;-2;0
21/03/2019;04:00;4;4;0;Sonnig;1;-2;0
21/03/2019;05:00;43;27;16;Leicht bewölkt;0;-3;0
21/03/2019;06:00;131;81;50;Leicht bewölkt;0;-3;0
21/03/2019;07:00;944;621;323;Leicht bewölkt;2;-1;0
21/03/2019;08:00;600;348;252;Leicht bewölkt;3;1;0
21/03/2019;09:00;598;402;196;Leicht bewölkt;5;3;0
21/03/2019;10:00;350;181;169;Leicht bewölkt;7;5;0
21/03/2019;11:00;588;293;295;Sonnig;8;7;0
21/03/2019;12:00;519;231;288;Sonnig;10;8;0
21/03/2019;13:00;825;326;499;Sonnig;11;9;0
21/03/2019;14:00;556;257;299;Sonnig;11;10;0
21/03/2019;15:00;845;416;429;Sonnig;12;11;0
21/03/2019;16:00;723;330;393;Sonnig;11;10;0
21/03/2019;17:00;936;372;564;Leicht bewölkt;11;10;0
21/03/2019;18:00;773;361;412;Leicht bewölkt;10;10;0
21/03/2019;19:00;467;214;253;Leicht bewölkt;9;9;0
21/03/2019;20:00;331;166;165;Leicht bewölkt;8;8;0
21/03/2019;21:00;227;87;140;Leicht bewölkt;6;6;0
21/03/2019;22:00;231;75;156;Leicht bewölkt;6;6;0
21/03/2019;23:00;98;35;63;Leicht bewölkt;5;5;0
22/03/2019;00:00;54;11;43;Leicht bewölkt;5;5;0
22/03/2019;01:00;32;12;20;Leicht bewölkt;5;5;0
22/03/2019;02:00;18;8;10;Sonnig;5;5;0
22/03/2019;03:00;7;4;3;Sonnig;5;5;0
22/03/2019;04:00;13;11;2;Sonnig;4;4;0
22/03/2019;05:00;38;25;13;Leicht bewölkt;3;3;0
22/03/2019;06:00;141;85;56;Leicht bewölkt;3;3;0
22/03/2019;07:00;799;519;280;Leicht bewölkt;4;4;0
22/03/2019;08:00;588;342;246;Leicht bewölkt;6;6;0
22/03/2019;09:00;563;353;210;Leicht bewölkt;8;8;0
22/03/2019;10:00;438;247;191;Leicht bewölkt;10;10;0
22/03/2019;11:00;516;238;278;Leicht bewölkt;12;12;0
22/03/2019;12:00;654;267;387;Leicht bewölkt;14;14;0
22/03/2019;13:00;843;320;523;Leicht bewölkt;14;14;0
22/03/2019;14:00;540;234;306;Leicht bewölkt;15;15;0
22/03/2019;15:00;571;270;301;Leicht bewölkt;15;15;0
22/03/2019;16:00;611;302;309;Leicht bewölkt;15;15;0
22/03/2019;17:00;708;330;378;Leicht bewölkt;14;14;0
22/03/2019;18:00;554;257;297;Leicht bewölkt;14;14;0
22/03/2019;19:00;464;228;236;Leicht bewölkt;13;13;0
22/03/2019;20:00;280;133;147;Bedeckt;13;13;0
22/03/2019;21:00;205;96;109;Bedeckt;12;12;0
22/03/2019;22:00;175;64;111;Bedeckt;11;11;0
22/03/2019;23:00;150;46;104;Leicht bewölkt;10;10;0
23/03/2019;00:00;93;30;63;Leicht bewölkt;9;9;0
23/03/2019;01:00;80;27;53;Leicht bewölkt;8;8;0
23/03/2019;02:00;47;22;25;Sonnig;8;8;0
23/03/2019;03:00;28;9;19;Sonnig;7;7;0
23/03/2019;04:00;14;10;4;Sonnig;7;7;0
23/03/2019;05:00;21;14;7;Sonnig;7;7;0
23/03/2019;06:00;37;23;14;Sonnig;7;7;0
23/03/2019;07:00;67;40;27;Sonnig;8;8;0
23/03/2019;08:00;188;130;58;Sonnig;10;10;0
23/03/2019;09:00;302;178;124;Sonnig;12;12;0
23/03/2019;10:00;390;210;180;Sonnig;14;14;0
23/03/2019;11:00;526;265;261;Sonnig;15;16;0
23/03/2019;12:00;584;314;270;Sonnig;17;18;0
23/03/2019;13:00;537;257;280;Sonnig;18;18;0
23/03/2019;14:00;573;288;285;Sonnig;18;19;0
23/03/2019;15:00;500;277;223;Sonnig;19;19;0
23/03/2019;16:00;492;223;269;Sonnig;18;18;0
23/03/2019;17:00;540;256;284;Sonnig;17;17;0
23/03/2019;18:00;459;209;250;Sonnig;16;16;0
23/03/2019;19:00;358;168;190;Sonnig;16;16;0
23/03/2019;20:00;241;138;103;Sonnig;15;15;0
23/03/2019;21:00;189;87;102;Sonnig;14;14;0
23/03/2019;22:00;172;56;116;Sonnig;13;13;0
23/03/2019;23:00;125;51;74;Sonnig;11;11;0
24/03/2019;00:00;110;41;69;Sonnig;10;10;0
24/03/2019;01:00;79;31;48;Sonnig;9;9;0
24/03/2019;02:00;52;17;35;Sonnig;8;8;0
24/03/2019;03:00;25;6;19;Sonnig;7;7;0
24/03/2019;04:00;17;7;10;Sonnig;7;7;0
24/03/2019;05:00;9;4;5;Leicht bewölkt;6;6;0
24/03/2019;06:00;15;11;4;Leicht bewölkt;6;6;0
24/03/2019;07:00;38;18;20;Leicht bewölkt;7;7;0
24/03/2019;08:00;78;44;34;Leicht bewölkt;9;9;0
24/03/2019;09:00;168;89;79;Leicht bewölkt;10;10;0
24/03/2019;10:00;225;109;116;Leicht bewölkt;12;12;0
24/03/2019;11:00;310;159;151;Bewölkt;13;13;0
24/03/2019;12:00;344;158;186;Bewölkt;15;15;0
24/03/2019;13:00;422;199;223;Bewölkt;15;15;0
24/03/2019;14:00;438;206;232;Leicht bewölkt;16;16;0
24/03/2019;15:00;541;279;262;Leicht bewölkt;16;16;0
24/03/2019;16:00;525;281;244;Leicht bewölkt;16;16;0
24/03/2019;17:00;551;300;251;Leicht bewölkt;15;15;0
24/03/2019;18:00;338;200;138;Leicht bewölkt;15;15;0
24/03/2019;19:00;231;116;115;Leicht bewölkt;14;14;0
24/03/2019;20:00;200;61;139;Leicht bewölkt;13;13;0
24/03/2019;21:00;90;50;40;Leicht bewölkt;12;12;0
24/03/2019;22:00;85;27;58;Leicht bewölkt;11;11;0
24/03/2019;23:00;56;16;40;Stellenweiser Regenfall;10;10;0
25/03/2019;00:00;17;10;7;Stellenweiser Regenfall;9;9;0
25/03/2019;01:00;9;4;5;Stellenweiser Regenfall;9;8;0
25/03/2019;02:00;6;2;4;Nieselregen;8;7;0
25/03/2019;03:00;2;0;2;Nieselregen;8;7;0
25/03/2019;04:00;4;4;0;Nieselregen;7;6;0
25/03/2019;05:00;37;22;15;Leichter Regenschauer;7;6;0
25/03/2019;06:00;156;104;52;Leichter Regenschauer;7;5;0
25/03/2019;07:00;964;645;319;Leichter Regenschauer;7;5;0
25/03/2019;08:00;573;330;243;Leichter Regenschauer;7;5;0
25/03/2019;09:00;571;387;184;Leichter Regenschauer;8;6;0
25/03/2019;10:00;344;186;158;Leichter Regenschauer;8;6;0
25/03/2019;11:00;525;244;281;Leicht bewölkt;9;7;0
25/03/2019;12:00;493;219;274;Leicht bewölkt;9;7;0
25/03/2019;13:00;813;310;503;Leicht bewölkt;9;7;0
25/03/2019;14:00;468;221;247;Leicht bewölkt;9;6;0
25/03/2019;15:00;752;378;374;Leicht bewölkt;9;6;0
25/03/2019;16:00;651;298;353;Leicht bewölkt;8;5;0
25/03/2019;17:00;819;351;468;Stellenweiser Regenfall;7;4;0
25/03/2019;18:00;666;277;389;Stellenweiser Regenfall;6;3;0
25/03/2019;19:00;489;242;247;Stellenweiser Regenfall;5;3;0
25/03/2019;20:00;292;127;165;Leicht bewölkt;4;2;0
25/03/2019;21:00;200;92;108;Leicht bewölkt;3;2;0
25/03/2019;22:00;145;50;95;Leicht bewölkt;2;2;0
25/03/2019;23:00;88;25;63;Stellenweiser Regenfall;2;2;0
26/03/2019;00:00;51;21;30;Stellenweiser Regenfall;2;2;0
26/03/2019;01:00;18;5;13;Stellenweiser Regenfall;1;1;0
26/03/2019;02:00;6;3;3;Mäßige bis starke Schneefälle;1;1;0
26/03/2019;03:00;2;0;2;Mäßige bis starke Schneefälle;1;1;0
26/03/2019;04:00;6;5;1;Mäßige bis starke Schneefälle;1;1;0
26/03/2019;05:00;34;21;13;Leicht bewölkt;1;0;0
26/03/2019;06:00;152;95;57;Leicht bewölkt;1;-1;0
26/03/2019;07:00;1030;722;308;Leicht bewölkt;2;0;0
26/03/2019;08:00;655;379;276;Bewölkt;3;1;0
26/03/2019;09:00;656;427;229;Bewölkt;4;2;0
26/03/2019;10:00;372;221;151;Bewölkt;5;3;0
26/03/2019;11:00;527;236;291;Leicht bewölkt;6;4;0
26/03/2019;12:00;498;215;283;Leicht bewölkt;7;5;0
26/03/2019;13:00;823;358;465;Leicht bewölkt;7;5;0
26/03/2019;14:00;440;214;226;Leicht bewölkt;7;6;0
26/03/2019;15:00;876;376;500;Leicht bewölkt;8;6;0
26/03/2019;16:00;647;297;350;Leicht bewölkt;7;6;0
26/03/2019;17:00;925;371;554;Leicht bewölkt;7;5;0
26/03/2019;18:00;706;331;375;Leicht bewölkt;6;4;0
26/03/2019;19:00;624;289;335;Leicht bewölkt;6;4;0
26/03/2019;20:00;305;137;168;Leicht bewölkt;5;3;0
26/03/2019;21:00;236;82;154;Leicht bewölkt;5;3;0
26/03/2019;22:00;189;71;118;Leicht bewölkt;4;2;0
26/03/2019;23:00;98;33;65;Leicht bewölkt;3;1;0
27/03/2019;00:00;46;15;31;Leicht bewölkt;3;1;0
27/03/2019;01:00;15;6;9;Leicht bewölkt;2;0;0
27/03/2019;02:00;15;10;5;Leicht bewölkt;2;0;0
27/03/2019;03:00;5;2;3;Leicht bewölkt;1;-1;0
27/03/2019;04:00;4;3;1;Leicht bewölkt;1;-1;0
27/03/2019;05:00;48;24;24;Leicht bewölkt;1;-1;0
27/03/2019;06:00;148;101;47;Leicht bewölkt;1;-1;0
27/03/2019;07:00;1098;762;336;Leicht bewölkt;2;1;0
27/03/2019;08:00;646;398;248;Leicht bewölkt;4;2;0
27/03/2019;09:00;556;344;212;Leicht bewölkt;5;3;0
27/03/2019;10:00;365;194;171;Leicht bewölkt;6;4;0
27/03/2019;11:00;577;237;340;Leicht bewölkt;8;6;0
27/03/2019;12:00;550;235;315;Leicht bewölkt;9;7;0
27/03/2019;13:00;867;438;429;Leicht bewölkt;10;7;0
27/03/2019;14:00;556;249;307;Leicht bewölkt;10;8;0
27/03/2019;15:00;788;346;442;Leicht bewölkt;10;8;0
27/03/2019;16:00;698;330;368;Leicht bewölkt;10;8;0
27/03/2019;17:00;898;395;503;Leicht bewölkt;9;7;0
27/03/2019;18:00;754;312;442;Leicht bewölkt;8;7;0
27/03/2019;19:00;574;248;326;Leicht bewölkt;7;5;0
27/03/2019;20:00;427;181;246;Leicht bewölkt;5;4;0
27/03/2019;21:00;257;115;142;Leicht bewölkt;4;2;0
27/03/2019;22:00;233;100;133;Leicht bewölkt;4;1;0
27/03/2019;23:00;100;39;61;Leicht bewölkt;3;0;0
28/03/2019;00:00;57;6;51;Leicht bewölkt;2;-1;0
28/03/2019;01:00;32;11;21;Leicht bewölkt;2;-1;0
28/03/2019;02:00;6;4;2;Leicht bewölkt;1;-1;0
28/03/2019;03:00;8;5;3;Leicht bewölkt;1;-1;0
28/03/2019;04:00;4;4;0;Leicht bewölkt;1;-1;0
28/03/2019;05:00;32;21;11;Leicht bewölkt;1;-1;0
28/03/2019;06:00;138;89;49;Leicht bewölkt;1;-1;0
28/03/2019;07:00;926;640;286;Leicht bewölkt;3;1;0
28/03/2019;08:00;684;409;275;Leicht bewölkt;5;3;0
28/03/2019;09:00;655;426;229;Leicht bewölkt;6;4;0
28/03/2019;10:00;403;217;186;Leicht bewölkt;8;6;0
28/03/2019;11:00;567;282;285;Leicht bewölkt;10;7;0
28/03/2019;12:00;558;221;337;Leicht bewölkt;11;9;0
28/03/2019;13:00;817;323;494;Leicht bewölkt;12;9;0
28/03/2019;14:00;528;237;291;Leicht bewölkt;12;10;0
28/03/2019;15:00;923;410;513;Leicht bewölkt;13;10;0
28/03/2019;16:00;794;362;432;Leicht bewölkt;11;9;0
28/03/2019;17:00;996;404;592;Leicht bewölkt;10;8;0
28/03/2019;18:00;808;359;449;Leicht bewölkt;9;7;0
28/03/2019;19:00;518;231;287;Leicht bewölkt;8;5;0
28/03/2019;20:00;376;169;207;Leicht bewölkt;7;4;0
28/03/2019;21:00;248;116;132;Leicht bewölkt;6;3;0
28/03/2019;22:00;235;80;155;Leicht bewölkt;5;2;0
28/03/2019;23:00;143;61;82;Leicht bewölkt;5;2;0
29/03/2019;00:00;73;23;50;Leicht bewölkt;4;2;0
29/03/2019;01:00;47;20;27;Leicht bewölkt;4;1;0
29/03/2019;02:00;10;6;4;Leicht bewölkt;3;1;0
29/03/2019;03:00;12;6;6;Leicht bewölkt;3;1;0
29/03/2019;04:00;14;10;4;Leicht bewölkt;3;1;0
29/03/2019;05:00;44;26;18;Leicht bewölkt;3;2;0
29/03/2019;06:00;138;91;47;Leicht bewölkt;3;2;0
29/03/2019;07:00;880;593;287;Leicht bewölkt;5;4;0
29/03/2019;08:00;634;393;241;Sonnig;7;7;0
29/03/2019;09:00;564;357;207;Sonnig;9;9;0
29/03/2019;10:00;451;262;189;Sonnig;11;11;0
29/03/2019;11:00;565;246;319;Sonnig;13;13;0
29/03/2019;12:00;694;298;396;Sonnig;16;16;0
29/03/2019;13:00;885;392;493;Sonnig;16;16;0
29/03/2019;14:00;671;336;335;Sonnig;17;17;0
29/03/2019;15:00;707;307;400;Sonnig;18;18;0
29/03/2019;16:00;671;342;329;Sonnig;17;17;0
29/03/2019;17:00;712;304;408;Sonnig;17;17;0
29/03/2019;18:00;580;242;338;Sonnig;16;16;0
29/03/2019;19:00;465;186;279;Sonnig;16;16;0
29/03/2019;20:00;325;141;184;Leicht bewölkt;15;15;0
29/03/2019;21:00;212;115;97;Leicht bewölkt;14;14;0
29/03/2019;22:00;220;99;121;Leicht bewölkt;12;12;0
29/03/2019;23:00;133;35;98;Leicht bewölkt;10;10;0
30/03/2019;00:00;91;33;58;Leicht bewölkt;8;8;0
30/03/2019;01:00;101;29;72;Leicht bewölkt;7;7;0
30/03/2019;02:00;42;21;21;Leicht bewölkt;6;6;0
30/03/2019;03:00;15;4;11;Leicht bewölkt;5;5;0
30/03/2019;04:00;19;12;7;Leicht bewölkt;5;5;0
30/03/2019;05:00;15;11;4;Leicht bewölkt;5;5;0
30/03/2019;06:00;44;25;19;Leicht bewölkt;5;5;0
30/03/2019;07:00;97;57;40;Leicht bewölkt;6;6;0
30/03/2019;08:00;175;84;91;Leicht bewölkt;8;8;0
30/03/2019;09:00;398;233;165;Leicht bewölkt;10;10;0
30/03/2019;10:00;444;248;196;Leicht bewölkt;12;12;0
30/03/2019;11:00;604;320;284;Leicht bewölkt;14;14;0
30/03/2019;12:00;588;296;292;Leicht bewölkt;16;16;0
30/03/2019;13:00;574;278;296;Leicht bewölkt;16;16;0
30/03/2019;14:00;612;298;314;Leicht bewölkt;17;17;0
30/03/2019;15:00;607;276;331;Leicht bewölkt;17;17;0
30/03/2019;16:00;575;290;285;Leicht bewölkt;16;16;0
30/03/2019;17:00;657;332;325;Leicht bewölkt;15;15;0
30/03/2019;18:00;504;243;261;Leicht bewölkt;14;14;0
30/03/2019;19:00;460;274;186;Leicht bewölkt;13;13;0
30/03/2019;20:00;282;137;145;Sonnig;11;11;0
30/03/2019;21:00;229;99;130;Sonnig;10;10;0
30/03/2019;22:00;222;66;156;Sonnig;9;9;0
30/03/2019;23:00;193;61;132;Leicht bewölkt;8;8;0
31/03/2019;00:00;156;39;117;Leicht bewölkt;7;7;0
31/03/2019;01:00;101;45;56;Leicht bewölkt;7;7;0
31/03/2019;03:00;79;24;55;Leicht bewölkt;6;6;0
31/03/2019;04:00;36;10;26;Leicht bewölkt;6;6;0
31/03/2019;05:00;43;20;23;Leicht bewölkt;6;6;0
31/03/2019;06:00;32;16;16;Leicht bewölkt;6;6;0
31/03/2019;07:00;44;21;23;Leicht bewölkt;8;8;0
31/03/2019;08:00;68;41;27;Leicht bewölkt;10;10;0
31/03/2019;09:00;171;105;66;Leicht bewölkt;12;12;0
31/03/2019;10:00;226;114;112;Leicht bewölkt;13;13;0
31/03/2019;11:00;342;160;182;Leicht bewölkt;14;14;0
31/03/2019;12:00;373;174;199;Leicht bewölkt;16;16;0
31/03/2019;13:00;475;211;264;Leicht bewölkt;16;16;0
31/03/2019;14:00;507;252;255;Leicht bewölkt;16;16;0
31/03/2019;15:00;502;242;260;Leicht bewölkt;16;16;0
31/03/2019;16:00;469;281;188;Leicht bewölkt;16;16;0
31/03/2019;17:00;580;277;303;Leicht bewölkt;15;15;0
31/03/2019;18:00;464;246;218;Leicht bewölkt;14;14;0
31/03/2019;19:00;331;172;159;Leicht bewölkt;13;13;0
31/03/2019;20:00;231;107;124;Leicht bewölkt;12;11;0
31/03/2019;21:00;148;47;101;Leicht bewölkt;11;10;0
31/03/2019;22:00;104;44;60;Leicht bewölkt;10;9;0
31/03/2019;23:00;61;20;41;Leicht bewölkt;9;8;0
01/04/2019;00:00;17;5;12;Leicht bewölkt;8;7;0
01/04/2019;01:00;15;7;8;Leicht bewölkt;8;6;0
01/04/2019;02:00;8;4;4;Leicht bewölkt;7;6;0
01/04/2019;03:00;2;2;0;Leicht bewölkt;7;5;0
01/04/2019;04:00;9;1;8;Leicht bewölkt;7;5;0
01/04/2019;05:00;35;21;14;Leicht bewölkt;7;5;0
01/04/2019;06:00;147;96;51;Leicht bewölkt;7;5;0
01/04/2019;07:00;970;666;304;Leicht bewölkt;8;6;0
01/04/2019;08:00;664;377;287;Leicht bewölkt;9;7;0
01/04/2019;09:00;605;398;207;Leicht bewölkt;10;8;0
01/04/2019;10:00;374;206;168;Leicht bewölkt;11;10;0
01/04/2019;11:00;562;293;269;Leicht bewölkt;13;12;0
01/04/2019;12:00;569;255;314;Leicht bewölkt;14;14;0
01/04/2019;13:00;895;343;552;Leicht bewölkt;15;14;0
01/04/2019;14:00;599;318;281;Sonnig;15;15;0
01/04/2019;15:00;941;418;523;Sonnig;16;16;0
01/04/2019;16:00;788;355;433;Sonnig;16;16;0
01/04/2019;17:00;1054;433;621;Leicht bewölkt;15;15;0
01/04/2019;18:00;835;383;452;Leicht bewölkt;15;15;0
01/04/2019;19:00;693;297;396;Leicht bewölkt;14;14;0
01/04/2019;20:00;436;203;233;Leicht bewölkt;13;13;0
01/04/2019;21:00;272;113;159;Leicht bewölkt;12;12;0
01/04/2019;22:00;217;104;113;Leicht bewölkt;11;11;0
01/04/2019;23:00;108;29;79;Leicht bewölkt;9;9;0
02/04/2019;00:00;47;16;31;Leicht bewölkt;8;8;0
02/04/2019;01:00;37;11;26;Leicht bewölkt;7;7;0
02/04/2019;02:00;11;6;5;Bedeckt;7;6;0
02/04/2019;03:00;13;11;2;Bedeckt;6;6;0
02/04/2019;04:00;5;2;3;Bedeckt;6;6;0
02/04/2019;05:00;37;24;13;Leicht bewölkt;6;6;0
02/04/2019;06:00;155;97;58;Leicht bewölkt;7;6;0
02/04/2019;07:00;1070;764;306;Leicht bewölkt;8;8;0
02/04/2019;08:00;789;442;347;Leicht bewölkt;10;10;0
02/04/2019;09:00;753;508;245;Leicht bewölkt;12;12;0
02/04/2019;10:00;429;239;190;Leicht bewölkt;13;13;0
02/04/2019;11:00;613;271;342;Leicht bewölkt;15;15;0
02/04/2019;12:00;660;277;383;Leicht bewölkt;17;17;0
02/04/2019;13:00;1030;475;555;Leicht bewölkt;17;17;0
02/04/2019;14:00;563;289;274;Leicht bewölkt;17;17;0
02/04/2019;15:00;963;410;553;Leicht bewölkt;18;18;0
02/04/2019;16:00;897;434;463;Leicht bewölkt;17;17;0
02/04/2019;17:00;1071;439;632;Bewölkt;16;16;0
02/04/2019;18:00;823;360;463;Bewölkt;16;16;0
02/04/2019;19:00;769;322;447;Bewölkt;15;15;0
02/04/2019;20:00;411;171;240;Bewölkt;14;14;0
02/04/2019;21:00;289;122;167;Bewölkt;13;13;0
02/04/2019;22:00;213;70;143;Bewölkt;12;11;0
02/04/2019;23:00;115;50;65;Leicht bewölkt;11;10;0
03/04/2019;00:00;45;16;29;Leicht bewölkt;10;9;0
03/04/2019;01:00;25;9;16;Leicht bewölkt;9;8;0
03/04/2019;02:00;7;3;4;Leicht bewölkt;8;7;0
03/04/2019;03:00;11;6;5;Leicht bewölkt;7;6;0
03/04/2019;04:00;5;4;1;Leicht bewölkt;7;6;0
03/04/2019;05:00;50;35;15;Bewölkt;7;6;0
03/04/2019;06:00;151;95;56;Bewölkt;7;7;0
03/04/2019;07:00;1134;780;354;Bewölkt;8;8;0
03/04/2019;08:00;698;437;261;Bewölkt;10;10;0
03/04/2019;09:00;675;446;229;Bewölkt;11;11;0
03/04/2019;10:00;433;232;201;Bewölkt;12;12;0
03/04/2019;11:00;585;276;309;Leicht bewölkt;13;13;0
03/04/2019;12:00;694;299;395;Leicht bewölkt;14;14;0
03/04/2019;13:00;1033;476;557;Leicht bewölkt;15;14;0
03/04/2019;14:00;637;317;320;Leicht bewölkt;15;15;0
03/04/2019;15:00;802;355;447;Leicht bewölkt;16;16;0
03/04/2019;16:00;791;373;418;Leicht bewölkt;15;15;0
03/04/2019;17:00;1050;427;623;Leicht bewölkt;14;14;0
03/04/2019;18:00;692;290;402;Leicht bewölkt;14;14;0
03/04/2019;19:00;620;246;374;Leicht bewölkt;12;12;0
03/04/2019;20:00;386;175;211;Leicht bewölkt;11;11;0
03/04/2019;21:00;262;127;135;Leicht bewölkt;10;10;0
03/04/2019;22:00;197;79;118;Leicht bewölkt;8;8;0
03/04/2019;23:00;130;52;78;Bewölkt;7;7;0
04/04/2019;00:00;86;20;66;Bewölkt;5;5;0
04/04/2019;01:00;43;10;33;Bewölkt;5;4;0
04/04/2019;02:00;19;7;12;Bewölkt;4;3;0
04/04/2019;03:00;8;1;7;Bewölkt;4;2;0
04/04/2019;04:00;5;2;3;Bewölkt;4;1;0
04/04/2019;05:00;37;26;11;Bedeckt;4;1;0
04/04/2019;06:00;129;68;61;Bedeckt;4;0;0
04/04/2019;07:00;884;611;273;Bedeckt;4;1;0
04/04/2019;08:00;572;353;219;Bedeckt;4;1;0
04/04/2019;09:00;471;309;162;Bedeckt;5;2;0
04/04/2019;10:00;213;115;98;Bedeckt;4;2;0
04/04/2019;11:00;394;194;200;Leichter Regenfall;4;1;0
04/04/2019;12:00;338;124;214;Leichter Regenfall;4;1;0
04/04/2019;13:00;574;241;333;Leichter Regenfall;4;1;0
04/04/2019;14:00;311;145;166;Leichter Eisregen;4;0;0
04/04/2019;15:00;597;241;356;Leichter Eisregen;4;0;1
04/04/2019;16:00;448;219;229;Leichter Eisregen;3;-1;0
04/04/2019;17:00;599;241;358;Mäßiger bis starker Eisregen;3;-1;1
04/04/2019;18:00;515;245;270;Mäßiger bis starker Eisregen;3;-1;1
04/04/2019;19:00;393;174;219;Mäßiger bis starker Eisregen;3;-1;1
04/04/2019;20:00;249;106;143;Starker Schneefall;3;0;0
04/04/2019;21:00;153;62;91;Starker Schneefall;3;0;1
04/04/2019;22:00;151;69;82;Starker Schneefall;3;0;0
04/04/2019;23:00;100;46;54;Starker Schneefall;3;0;0
05/04/2019;00:00;53;13;40;Starker Schneefall;2;0;0
05/04/2019;01:00;28;3;25;Starker Schneefall;2;1;0
05/04/2019;02:00;10;2;8;Starker Schneefall;2;1;0
05/04/2019;03:00;6;3;3;Starker Schneefall;2;2;0
05/04/2019;04:00;2;2;0;Starker Schneefall;2;2;0
05/04/2019;05:00;23;19;4;Starker Schneefall;3;2;0
05/04/2019;06:00;110;71;39;Starker Schneefall;3;2;0
05/04/2019;07:00;768;506;262;Starker Schneefall;3;3;0
05/04/2019;08:00;624;396;228;Mäßiger Schneefall;4;3;0
05/04/2019;09:00;520;354;166;Mäßiger Schneefall;4;3;0
05/04/2019;10:00;374;202;172;Mäßiger Schneefall;5;4;0
05/04/2019;11:00;529;251;278;Bedeckt;6;4;0
05/04/2019;12:00;633;275;358;Bedeckt;7;5;0
05/04/2019;13:00;833;272;561;Bedeckt;7;6;0
05/04/2019;14:00;544;259;285;Bewölkt;8;7;0
05/04/2019;15:00;559;257;302;Bewölkt;9;8;0
05/04/2019;16:00;603;302;301;Bewölkt;8;7;0
05/04/2019;17:00;639;267;372;Leicht bewölkt;8;6;0
05/04/2019;18:00;567;249;318;Leicht bewölkt;7;6;0
05/04/2019;19:00;419;205;214;Leicht bewölkt;6;5;0
05/04/2019;20:00;348;173;175;Leicht bewölkt;5;4;0
05/04/2019;21:00;225;110;115;Leicht bewölkt;5;4;0
05/04/2019;22:00;186;78;108;Leicht bewölkt;4;3;0
05/04/2019;23:00;190;59;131;Leicht bewölkt;4;3;0
06/04/2019;00:00;125;41;84;Leicht bewölkt;3;3;0
06/04/2019;01:00;89;18;71;Leicht bewölkt;3;3;0
06/04/2019;02:00;36;12;24;Leicht bewölkt;2;2;0
06/04/2019;03:00;30;19;11;Leicht bewölkt;2;2;0
06/04/2019;04:00;12;10;2;Leicht bewölkt;2;2;0
06/04/2019;05:00;22;12;10;Leicht bewölkt;3;2;0
06/04/2019;06:00;41;27;14;Leicht bewölkt;3;3;0
06/04/2019;07:00;78;44;34;Leicht bewölkt;5;4;0
06/04/2019;08:00;183;119;64;Leicht bewölkt;7;6;0
06/04/2019;09:00;335;204;131;Leicht bewölkt;8;8;0
06/04/2019;10:00;350;180;170;Leicht bewölkt;10;9;0
06/04/2019;11:00;412;195;217;Leicht bewölkt;12;11;0
06/04/2019;12:00;448;230;218;Leicht bewölkt;13;13;0
06/04/2019;13:00;518;275;243;Leicht bewölkt;14;14;0
06/04/2019;14:00;624;317;307;Leicht bewölkt;15;15;0
06/04/2019;15:00;540;271;269;Leicht bewölkt;16;16;0
06/04/2019;16:00;575;251;324;Leicht bewölkt;15;15;0
06/04/2019;17:00;549;247;302;Leicht bewölkt;14;14;0
06/04/2019;18:00;490;212;278;Leicht bewölkt;14;14;0
06/04/2019;19:00;310;141;169;Leicht bewölkt;13;13;0
06/04/2019;20:00;318;157;161;Leicht bewölkt;12;12;0
06/04/2019;21:00;206;95;111;Leicht bewölkt;11;11;0
06/04/2019;22:00;160;79;81;Leicht bewölkt;9;9;0
06/04/2019;23:00;150;49;101;Leicht bewölkt;8;7;0
07/04/2019;00:00;136;45;91;Leicht bewölkt;6;5;0
07/04/2019;01:00;109;45;64;Leicht bewölkt;6;5;0
07/04/2019;02:00;67;27;40;Leicht bewölkt;5;4;0
07/04/2019;03:00;42;11;31;Leicht bewölkt;4;3;0
07/04/2019;04:00;18;10;8;Leicht bewölkt;5;3;0
07/04/2019;05:00;18;13;5;Leicht bewölkt;5;4;0
07/04/2019;06:00;24;13;11;Leicht bewölkt;5;4;0
07/04/2019;07:00;25;14;11;Leicht bewölkt;6;5;0
07/04/2019;08:00;58;31;27;Bewölkt;7;6;0
07/04/2019;09:00;162;77;85;Bewölkt;8;7;0
07/04/2019;10:00;165;86;79;Bewölkt;9;8;0
07/04/2019;11:00;235;123;112;Bewölkt;10;9;0
07/04/2019;12:00;290;145;145;Bewölkt;11;10;0
07/04/2019;13:00;297;147;150;Bewölkt;12;11;0
07/04/2019;14:00;373;184;189;Bewölkt;12;11;0
07/04/2019;15:00;409;197;212;Bewölkt;13;12;0
07/04/2019;16:00;354;170;184;Bewölkt;12;11;0
07/04/2019;17:00;437;212;225;Leicht bewölkt;11;10;0
07/04/2019;18:00;324;153;171;Leicht bewölkt;10;9;0
07/04/2019;19:00;278;144;134;Leicht bewölkt;9;8;0
07/04/2019;20:00;215;100;115;Bewölkt;8;6;0
07/04/2019;21:00;125;51;74;Bewölkt;7;5;0
07/04/2019;22:00;100;46;54;Bewölkt;7;5;0
07/04/2019;23:00;53;20;33;Bedeckt;6;4;0
08/04/2019;00:00;21;9;12;Bedeckt;6;4;0
08/04/2019;01:00;13;9;4;Bedeckt;6;3;0
08/04/2019;02:00;12;5;7;Stellenweiser Regenfall;5;3;0
08/04/2019;03:00;2;2;0;Stellenweiser Regenfall;5;3;0
08/04/2019;04:00;6;5;1;Stellenweiser Regenfall;5;3;0
08/04/2019;05:00;38;26;12;Bewölkt;5;3;0
08/04/2019;06:00;144;93;51;Bewölkt;5;4;0
08/04/2019;07:00;842;553;289;Bewölkt;6;5;0
08/04/2019;08:00;646;361;285;Bewölkt;7;6;0
08/04/2019;09:00;636;435;201;Bewölkt;9;7;0
08/04/2019;10:00;264;147;117;Bewölkt;10;9;0
08/04/2019;11:00;113;73;40;Leicht bewölkt;11;10;0
08/04/2019;12:00;503;228;275;Leicht bewölkt;12;12;0
08/04/2019;13:00;820;302;518;Leicht bewölkt;13;12;0
08/04/2019;14:00;524;248;276;Bewölkt;13;13;0
08/04/2019;15:00;841;403;438;Bewölkt;13;14;0
08/04/2019;16:00;682;320;362;Bewölkt;12;13;0
08/04/2019;17:00;897;388;509;Leicht bewölkt;11;12;0
08/04/2019;18:00;781;321;460;Leicht bewölkt;10;11;0
08/04/2019;19:00;544;238;306;Leicht bewölkt;9;9;0
08/04/2019;20:00;365;139;226;Leicht bewölkt;8;8;0
08/04/2019;21:00;231;84;147;Leicht bewölkt;8;7;0
08/04/2019;22:00;160;61;99;Leicht bewölkt;7;6;0
08/04/2019;23:00;99;37;62;Stellenweiser Regenfall;7;6;0
09/04/2019;00:00;44;16;28;Stellenweiser Regenfall;6;5;0
09/04/2019;01:00;18;12;6;Stellenweiser Regenfall;6;5;0
09/04/2019;02:00;9;5;4;Stellenweiser Nieselregen;6;5;0
09/04/2019;03:00;7;7;0;Stellenweiser Nieselregen;6;5;0
09/04/2019;04:00;1;1;0;Stellenweiser Nieselregen;6;5;0
09/04/2019;05:00;44;33;11;Nieselregen;6;6;0
09/04/2019;06:00;139;83;56;Nieselregen;7;6;0
09/04/2019;07:00;910;637;273;Nieselregen;8;7;0
09/04/2019;08:00;655;386;269;Nieselregen;9;8;0
09/04/2019;09:00;565;375;190;Nieselregen;9;9;0
09/04/2019;10:00;351;204;147;Nieselregen;11;11;0
09/04/2019;11:00;554;281;273;Stellenweiser Regenfall;12;12;0
09/04/2019;12:00;555;217;338;Stellenweiser Regenfall;13;13;0
09/04/2019;13:00;786;357;429;Stellenweiser Regenfall;13;14;0
09/04/2019;14:00;480;237;243;Bewölkt;14;14;0
09/04/2019;15:00;826;357;469;Bewölkt;15;15;0
09/04/2019;16:00;715;319;396;Bewölkt;14;14;0
09/04/2019;17:00;950;401;549;Bewölkt;13;13;0
09/04/2019;18:00;741;329;412;Bewölkt;13;13;0
09/04/2019;19:00;605;276;329;Bewölkt;11;11;0
09/04/2019;20:00;416;174;242;Bewölkt;10;10;0
09/04/2019;21:00;263;85;178;Bewölkt;9;9;0
09/04/2019;22:00;201;58;143;Bewölkt;8;8;0
09/04/2019;23:00;95;31;64;Leicht bewölkt;8;8;0
10/04/2019;00:00;49;16;33;Leicht bewölkt;7;7;0
10/04/2019;01:00;27;9;18;Leicht bewölkt;7;7;0
10/04/2019;02:00;12;7;5;Leicht bewölkt;7;6;0
10/04/2019;03:00;10;5;5;Leicht bewölkt;7;6;0
10/04/2019;04:00;10;9;1;Leicht bewölkt;7;6;0
10/04/2019;05:00;50;32;18;Leichter Regenfall;7;6;1
10/04/2019;06:00;112;72;40;Leichter Regenfall;7;6;1
10/04/2019;07:00;659;423;236;Leichter Regenfall;7;6;0
10/04/2019;08:00;443;301;142;Starker Regenfall;7;6;0
10/04/2019;09:00;431;310;121;Starker Regenfall;7;7;1
10/04/2019;10:00;229;136;93;Starker Regenfall;8;7;0
10/04/2019;11:00;342;154;188;Leichter Regenfall;8;8;0
10/04/2019;12:00;413;174;239;Leichter Regenfall;9;8;0
10/04/2019;13:00;596;289;307;Leichter Regenfall;9;9;0
10/04/2019;14:00;396;192;204;Mäßiger Regenfall;10;10;0
10/04/2019;15:00;535;231;304;Mäßiger Regenfall;10;10;0
10/04/2019;16:00;541;255;286;Mäßiger Regenfall;10;10;0
10/04/2019;17:00;737;301;436;Nieselregen;10;10;0
10/04/2019;18:00;626;302;324;Nieselregen;10;10;0
10/04/2019;19:00;459;203;256;Nieselregen;9;9;0
10/04/2019;20:00;298;133;165;Bedeckt;9;8;0
10/04/2019;21:00;230;88;142;Bedeckt;8;7;0
10/04/2019;22:00;184;65;119;Bedeckt;8;7;0
10/04/2019;23:00;106;36;70;Leichter Regenfall;8;6;0
11/04/2019;00:00;68;14;54;Leichter Regenfall;8;5;0
11/04/2019;01:00;42;3;39;Leichter Regenfall;8;5;0
11/04/2019;02:00;12;5;7;Leichter Regenfall;7;4;0
11/04/2019;03:00;5;3;2;Leichter Regenfall;7;4;0
11/04/2019;04:00;7;4;3;Leichter Regenfall;7;4;0
11/04/2019;05:00;51;38;13;Bedeckt;7;4;0
11/04/2019;06:00;136;89;47;Bedeckt;7;4;0
11/04/2019;07:00;892;591;301;Bedeckt;7;4;0
11/04/2019;08:00;587;373;214;Stellenweiser Regenfall;7;4;0
11/04/2019;09:00;575;370;205;Stellenweiser Regenfall;7;4;0
11/04/2019;10:00;328;192;136;Stellenweiser Regenfall;8;5;0
11/04/2019;11:00;565;287;278;Stellenweiser Regenfall;8;5;0
11/04/2019;12:00;503;219;284;Stellenweiser Regenfall;9;6;0
11/04/2019;13:00;721;342;379;Stellenweiser Regenfall;9;6;0
11/04/2019;14:00;475;205;270;Stellenweiser Regenfall;9;7;0
11/04/2019;15:00;803;376;427;Stellenweiser Regenfall;10;8;0
11/04/2019;16:00;770;375;395;Stellenweiser Regenfall;10;7;0
11/04/2019;17:00;891;358;533;Bewölkt;9;7;0
11/04/2019;18:00;770;353;417;Bewölkt;9;6;0
11/04/2019;19:00;541;211;330;Bewölkt;8;5;0
11/04/2019;20:00;380;154;226;Stellenweiser Regenfall;7;5;0
11/04/2019;21:00;229;96;133;Stellenweiser Regenfall;7;4;0
11/04/2019;22:00;200;85;115;Stellenweiser Regenfall;6;3;0
11/04/2019;23:00;122;49;73;Leicht bewölkt;6;3;0
12/04/2019;00:00;66;24;42;Leicht bewölkt;5;2;0
12/04/2019;01:00;53;19;34;Leicht bewölkt;4;1;0
12/04/2019;02:00;15;7;8;Bewölkt;4;0;0
12/04/2019;03:00;8;5;3;Bewölkt;3;-1;0
12/04/2019;04:00;7;6;1;Bewölkt;2;-1;0
12/04/2019;05:00;31;23;8;Leicht bewölkt;2;-1;0
12/04/2019;06:00;145;98;47;Leicht bewölkt;2;-1;0
12/04/2019;07:00;599;322;277;Leicht bewölkt;3;1;0
12/04/2019;08:00;695;438;257;Leicht bewölkt;5;2;0
12/04/2019;09:00;752;538;214;Leicht bewölkt;6;4;0
12/04/2019;10:00;377;204;173;Leicht bewölkt;7;5;0
12/04/2019;11:00;619;323;296;Leicht bewölkt;8;6;0
12/04/2019;12:00;689;280;409;Leicht bewölkt;9;7;0
12/04/2019;13:00;879;313;566;Leicht bewölkt;9;7;0
12/04/2019;14:00;608;271;337;Leicht bewölkt;9;8;0
12/04/2019;15:00;671;327;344;Leicht bewölkt;9;8;0
12/04/2019;16:00;606;279;327;Leicht bewölkt;9;7;0
12/04/2019;17:00;675;280;395;Bedeckt;8;6;0
12/04/2019;18:00;569;263;306;Bedeckt;7;5;0
12/04/2019;19:00;448;222;226;Bedeckt;7;5;0
12/04/2019;20:00;392;209;183;Bewölkt;6;4;0
12/04/2019;21:00;239;140;99;Bewölkt;5;3;0
12/04/2019;22:00;197;81;116;Bewölkt;5;3;0
12/04/2019;23:00;168;54;114;Leicht bewölkt;4;2;0
13/04/2019;00:00;148;46;102;Leicht bewölkt;3;1;0
13/04/2019;01:00;124;47;77;Leicht bewölkt;3;1;0
13/04/2019;02:00;57;22;35;Leicht bewölkt;2;1;0
13/04/2019;03:00;32;10;22;Leicht bewölkt;2;0;0
13/04/2019;04:00;20;7;13;Leicht bewölkt;2;1;0
13/04/2019;05:00;22;11;11;Leicht bewölkt;2;2;0
13/04/2019;06:00;37;21;16;Leicht bewölkt;3;2;0
13/04/2019;07:00;61;32;29;Leicht bewölkt;4;4;0
13/04/2019;08:00;155;94;61;Leicht bewölkt;6;6;0
13/04/2019;09:00;266;166;100;Leicht bewölkt;8;8;0
13/04/2019;10:00;344;191;153;Leicht bewölkt;9;9;0
13/04/2019;11:00;410;228;182;Leicht bewölkt;10;10;0
13/04/2019;12:00;477;250;227;Leicht bewölkt;11;11;0
13/04/2019;13:00;506;273;233;Leicht bewölkt;11;10;0
13/04/2019;14:00;436;219;217;Leicht bewölkt;11;9;0
13/04/2019;15:00;420;203;217;Leicht bewölkt;10;9;0
13/04/2019;16:00;470;208;262;Leicht bewölkt;10;8;0
13/04/2019;17:00;435;168;267;Stellenweiser Regenfall;9;8;0
13/04/2019;18:00;407;174;233;Stellenweiser Regenfall;8;8;0
13/04/2019;19:00;363;185;178;Stellenweiser Regenfall;8;7;0
13/04/2019;20:00;259;110;149;Leichter Regenschauer;7;7;0
13/04/2019;21:00;209;96;113;Leichter Regenschauer;6;6;0
13/04/2019;22:00;171;81;90;Leichter Regenschauer;5;5;0
13/04/2019;23:00;139;48;91;Leichter Nebel;4;3;0
14/04/2019;00:00;139;57;82;Leichter Nebel;3;2;0
14/04/2019;01:00;86;35;51;Leichter Nebel;2;1;0
14/04/2019;02:00;80;32;48;Leichter Nebel;2;0;0
14/04/2019;03:00;45;24;21;Leichter Nebel;1;-1;0
14/04/2019;04:00;22;17;5;Leichter Nebel;1;0;0
14/04/2019;05:00;14;10;4;Leichter Schneefall;1;0;0
14/04/2019;06:00;26;16;10;Leichter Schneefall;2;0;0
14/04/2019;07:00;20;8;12;Leichter Schneefall;2;0;0
14/04/2019;08:00;45;25;20;Mäßiger Schneefall;3;1;0
14/04/2019;09:00;96;51;45;Mäßiger Schneefall;4;2;0
14/04/2019;10:00;89;44;45;Mäßiger Schneefall;5;3;0
14/04/2019;11:00;110;58;52;Stellenweiser Regenfall;6;4;0
14/04/2019;12:00;146;95;51;Stellenweiser Regenfall;7;5;0
14/04/2019;13:00;157;73;84;Stellenweiser Regenfall;7;5;0
14/04/2019;14:00;179;93;86;Nieselregen;8;6;0
14/04/2019;15:00;161;74;87;Nieselregen;8;6;0
14/04/2019;16:00;193;110;83;Nieselregen;8;6;0
14/04/2019;17:00;183;98;85;Leichter Regenschauer;7;5;0
14/04/2019;18:00;145;63;82;Leichter Regenschauer;7;5;0
14/04/2019;19:00;148;78;70;Leichter Regenschauer;6;4;0
14/04/2019;20:00;134;66;68;Leichter Regenschauer;5;3;0
14/04/2019;21:00;84;36;48;Leichter Regenschauer;4;2;0
14/04/2019;22:00;102;33;69;Leichter Regenschauer;3;2;0
14/04/2019;23:00;56;13;43;Leicht bewölkt;3;1;0
15/04/2019;00:00;27;7;20;Leicht bewölkt;2;1;0
15/04/2019;01:00;21;10;11;Leicht bewölkt;2;0;0
15/04/2019;02:00;9;7;2;Leicht bewölkt;1;-1;0
15/04/2019;03:00;1;0;1;Leicht bewölkt;1;-1;0
15/04/2019;04:00;7;2;5;Leicht bewölkt;1;-1;0
15/04/2019;05:00;43;29;14;Leicht bewölkt;2;-1;0
15/04/2019;06:00;139;90;49;Leicht bewölkt;2;0;0
15/04/2019;07:00;491;311;180;Leicht bewölkt;4;2;0
15/04/2019;08:00;527;318;209;Leicht bewölkt;6;4;0
15/04/2019;09:00;626;400;226;Leicht bewölkt;7;6;0
15/04/2019;10:00;374;208;166;Leicht bewölkt;9;8;0
15/04/2019;11:00;512;282;230;Leicht bewölkt;11;10;0
15/04/2019;12:00;535;230;305;Leicht bewölkt;13;12;0
15/04/2019;13:00;604;279;325;Leicht bewölkt;13;13;0
15/04/2019;14:00;535;263;272;Leicht bewölkt;14;14;0
15/04/2019;15:00;671;359;312;Leicht bewölkt;15;15;0
15/04/2019;16:00;750;326;424;Leicht bewölkt;15;14;0
15/04/2019;17:00;881;372;509;Leicht bewölkt;14;14;0
15/04/2019;18:00;857;388;469;Leicht bewölkt;14;14;0
15/04/2019;19:00;697;305;392;Leicht bewölkt;13;13;0
15/04/2019;20:00;451;189;262;Leicht bewölkt;13;13;0
15/04/2019;21:00;268;104;164;Leicht bewölkt;12;12;0
15/04/2019;22:00;223;78;145;Leicht bewölkt;10;10;0
15/04/2019;23:00;142;70;72;Leicht bewölkt;9;9;0
16/04/2019;00:00;64;23;41;Leicht bewölkt;7;7;0
16/04/2019;01:00;39;15;24;Leicht bewölkt;6;6;0
16/04/2019;02:00;17;9;8;Leicht bewölkt;5;5;0
16/04/2019;03:00;13;6;7;Leicht bewölkt;5;4;0
16/04/2019;04:00;14;10;4;Leicht bewölkt;5;5;0
16/04/2019;05:00;39;28;11;Leicht bewölkt;5;5;0
16/04/2019;06:00;158;102;56;Leicht bewölkt;6;5;0
16/04/2019;07:00;569;354;215;Leicht bewölkt;7;7;0
16/04/2019;08:00;567;339;228;Leicht bewölkt;9;8;0
16/04/2019;09:00;737;476;261;Leicht bewölkt;11;10;0
16/04/2019;10:00;478;274;204;Leicht bewölkt;12;11;0
16/04/2019;11:00;594;290;304;Leicht bewölkt;13;13;0
16/04/2019;12:00;633;266;367;Leicht bewölkt;14;14;0
16/04/2019;13:00;710;360;350;Leicht bewölkt;15;15;0
16/04/2019;14:00;605;356;249;Leicht bewölkt;15;15;0
16/04/2019;15:00;714;361;353;Leicht bewölkt;16;16;0
16/04/2019;16:00;773;335;438;Leicht bewölkt;15;15;0
16/04/2019;17:00;950;425;525;Leicht bewölkt;14;14;0
16/04/2019;18:00;751;329;422;Leicht bewölkt;13;13;0
16/04/2019;19:00;681;280;401;Leicht bewölkt;12;12;0
16/04/2019;20:00;450;184;266;Leichter Regenschauer;11;11;0
16/04/2019;21:00;266;116;150;Leichter Regenschauer;9;9;0
16/04/2019;22:00;206;74;132;Leichter Regenschauer;9;9;0
16/04/2019;23:00;170;70;100;Stellenweiser Regenfall;8;8;0
17/04/2019;00:00;60;13;47;Stellenweiser Regenfall;8;8;0
17/04/2019;01:00;20;7;13;Stellenweiser Regenfall;8;8;0
17/04/2019;02:00;13;4;9;Stellenweiser Regenfall;8;8;0
17/04/2019;03:00;5;2;3;Stellenweiser Regenfall;7;7;0
17/04/2019;04:00;10;7;3;Stellenweiser Regenfall;8;8;0
17/04/2019;05:00;44;22;22;Nieselregen;8;8;0
17/04/2019;06:00;149;91;58;Nieselregen;8;8;0
17/04/2019;07:00;652;424;228;Nieselregen;10;10;0
17/04/2019;08:00;607;389;218;Nieselregen;11;11;0
17/04/2019;09:00;704;416;288;Nieselregen;12;12;0
17/04/2019;10:00;466;259;207;Nieselregen;13;14;0
17/04/2019;11:00;609;265;344;Leicht bewölkt;15;15;0
17/04/2019;12:00;615;296;319;Leicht bewölkt;16;16;0
17/04/2019;13:00;651;325;326;Leicht bewölkt;16;16;0
17/04/2019;14:00;617;295;322;Leicht bewölkt;17;17;0
17/04/2019;15:00;734;359;375;Leicht bewölkt;17;17;0
17/04/2019;16:00;780;360;420;Leicht bewölkt;17;17;0
17/04/2019;17:00;965;436;529;Leicht bewölkt;16;16;0
17/04/2019;18:00;929;410;519;Leicht bewölkt;16;16;0
17/04/2019;19:00;752;356;396;Leicht bewölkt;15;15;0
17/04/2019;20:00;482;212;270;Leicht bewölkt;14;14;0
17/04/2019;21:00;421;199;222;Leicht bewölkt;13;13;0
17/04/2019;22:00;274;115;159;Leicht bewölkt;12;12;0
17/04/2019;23:00;216;84;132;Leicht bewölkt;11;10;0
18/04/2019;00:00;104;31;73;Leicht bewölkt;9;9;0
18/04/2019;01:00;75;20;55;Leicht bewölkt;9;8;0
18/04/2019;02:00;30;15;15;Leicht bewölkt;8;8;0
18/04/2019;03:00;20;12;8;Leicht bewölkt;7;7;0
18/04/2019;04:00;21;19;2;Leicht bewölkt;8;8;0
18/04/2019;05:00;47;33;14;Leicht bewölkt;8;8;0
18/04/2019;06:00;148;92;56;Leicht bewölkt;9;9;0
18/04/2019;07:00;514;320;194;Leicht bewölkt;10;10;0
18/04/2019;08:00;588;377;211;Leicht bewölkt;12;12;0
18/04/2019;09:00;608;362;246;Leicht bewölkt;14;14;0
18/04/2019;10:00;481;263;218;Leicht bewölkt;15;15;0
18/04/2019;11:00;656;366;290;Leicht bewölkt;16;16;0
18/04/2019;12:00;621;254;367;Leicht bewölkt;18;18;0
18/04/2019;13:00;693;337;356;Leicht bewölkt;18;18;0
18/04/2019;14:00;655;328;327;Leicht bewölkt;18;18;0
18/04/2019;15:00;815;378;437;Leicht bewölkt;19;19;0
18/04/2019;16:00;867;415;452;Leicht bewölkt;18;18;0
18/04/2019;17:00;947;396;551;Leicht bewölkt;17;17;0
18/04/2019;18:00;755;306;449;Leicht bewölkt;17;17;0
18/04/2019;19:00;609;277;332;Leicht bewölkt;16;16;0
18/04/2019;20:00;395;181;214;Leicht bewölkt;15;15;0
18/04/2019;21:00;254;117;137;Leicht bewölkt;14;14;0
18/04/2019;22:00;194;88;106;Leicht bewölkt;12;12;0
18/04/2019;23:00;159;69;90;Leicht bewölkt;11;11;0
19/04/2019;00:00;112;34;78;Leicht bewölkt;10;10;0
19/04/2019;01:00;75;26;49;Leicht bewölkt;9;9;0
19/04/2019;02:00;48;16;32;Leicht bewölkt;9;9;0
19/04/2019;03:00;28;14;14;Leicht bewölkt;9;8;0
19/04/2019;04:00;9;7;2;Leicht bewölkt;9;9;0
19/04/2019;05:00;10;7;3;Sonnig;10;10;0
19/04/2019;06:00;30;15;15;Sonnig;10;10;0
19/04/2019;07:00;38;21;17;Sonnig;12;12;0
19/04/2019;08:00;81;39;42;Leicht bewölkt;14;14;0
19/04/2019;09:00;236;141;95;Leicht bewölkt;16;16;0
19/04/2019;10:00;306;169;137;Leicht bewölkt;18;18;0
19/04/2019;11:00;387;179;208;Leicht bewölkt;19;19;0
19/04/2019;12:00;404;170;234;Leicht bewölkt;21;21;0
19/04/2019;13:00;424;197;227;Leicht bewölkt;21;21;0
19/04/2019;14:00;541;254;287;Leicht bewölkt;21;21;0
19/04/2019;15:00;500;256;244;Leicht bewölkt;21;21;0
19/04/2019;16:00;599;342;257;Leicht bewölkt;20;20;0
19/04/2019;17:00;473;263;210;Leicht bewölkt;19;19;0
19/04/2019;18:00;463;228;235;Leicht bewölkt;19;19;0
19/04/2019;19:00;415;165;250;Leicht bewölkt;17;17;0
19/04/2019;20:00;267;113;154;Leicht bewölkt;16;16;0
19/04/2019;21:00;209;94;115;Leicht bewölkt;15;15;0
19/04/2019;22:00;129;51;78;Leicht bewölkt;14;14;0
19/04/2019;23:00;96;41;55;Leicht bewölkt;12;12;0
20/04/2019;00:00;72;26;46;Leicht bewölkt;10;11;0
20/04/2019;01:00;38;15;23;Leicht bewölkt;10;10;0
20/04/2019;02:00;21;6;15;Leicht bewölkt;9;9;0
20/04/2019;03:00;14;4;10;Leicht bewölkt;9;9;0
20/04/2019;04:00;7;5;2;Leicht bewölkt;9;9;0
20/04/2019;05:00;16;9;7;Leicht bewölkt;9;10;0
20/04/2019;06:00;38;24;14;Leicht bewölkt;10;10;0
20/04/2019;07:00;55;34;21;Leicht bewölkt;12;12;0
20/04/2019;08:00;167;97;70;Leicht bewölkt;14;14;0
20/04/2019;09:00;384;233;151;Leicht bewölkt;15;15;0
20/04/2019;10:00;579;314;265;Leicht bewölkt;17;17;0
20/04/2019;11:00;604;328;276;Leicht bewölkt;18;18;0
20/04/2019;12:00;580;304;276;Leicht bewölkt;19;19;0
20/04/2019;13:00;651;339;312;Leicht bewölkt;19;19;0
20/04/2019;14:00;607;297;310;Leicht bewölkt;19;19;0
20/04/2019;15:00;637;291;346;Leicht bewölkt;20;20;0
20/04/2019;16:00;600;263;337;Leicht bewölkt;19;19;0
20/04/2019;17:00;611;296;315;Leicht bewölkt;18;18;0
20/04/2019;18:00;508;255;253;Leicht bewölkt;17;17;0
20/04/2019;19:00;366;206;160;Leicht bewölkt;16;16;0
20/04/2019;20:00;300;112;188;Leicht bewölkt;15;15;0
20/04/2019;21:00;207;104;103;Leicht bewölkt;14;14;0
20/04/2019;22:00;154;69;85;Leicht bewölkt;13;13;0
20/04/2019;23:00;109;26;83;Leicht bewölkt;12;12;0
21/04/2019;00:00;92;26;66;Leicht bewölkt;11;10;0
21/04/2019;01:00;67;25;42;Leicht bewölkt;10;10;0
21/04/2019;02:00;33;10;23;Leicht bewölkt;10;9;0
21/04/2019;03:00;17;3;14;Leicht bewölkt;9;9;0
21/04/2019;04:00;9;4;5;Leicht bewölkt;10;9;0
21/04/2019;05:00;16;10;6;Sonnig;10;10;0
21/04/2019;06:00;40;17;23;Sonnig;11;11;0
21/04/2019;07:00;34;14;20;Sonnig;12;12;0
21/04/2019;08:00;76;42;34;Sonnig;14;14;0
21/04/2019;09:00;209;101;108;Sonnig;16;16;0
21/04/2019;10:00;264;135;129;Sonnig;17;17;0
21/04/2019;11:00;349;172;177;Sonnig;18;18;0
21/04/2019;12:00;387;190;197;Sonnig;19;19;0
21/04/2019;13:00;349;151;198;Sonnig;20;20;0
21/04/2019;14:00;425;213;212;Leicht bewölkt;20;20;0
21/04/2019;15:00;438;241;197;Leicht bewölkt;20;20;0
21/04/2019;16:00;395;230;165;Leicht bewölkt;20;20;0
21/04/2019;17:00;355;183;172;Leicht bewölkt;19;19;0
21/04/2019;18:00;322;163;159;Leicht bewölkt;19;19;0
21/04/2019;19:00;304;153;151;Leicht bewölkt;18;18;0
21/04/2019;20:00;240;115;125;Leicht bewölkt;17;17;0
21/04/2019;21:00;158;70;88;Leicht bewölkt;16;16;0
21/04/2019;22:00;125;50;75;Leicht bewölkt;14;14;0
21/04/2019;23:00;71;28;43;Leicht bewölkt;13;13;0
22/04/2019;00:00;52;12;40;Leicht bewölkt;11;11;0
22/04/2019;01:00;63;25;38;Leicht bewölkt;10;10;0
22/04/2019;02:00;12;5;7;Leicht bewölkt;9;9;0
22/04/2019;03:00;11;4;7;Leicht bewölkt;8;8;0
22/04/2019;04:00;5;4;1;Leicht bewölkt;9;9;0
22/04/2019;05:00;10;6;4;Leicht bewölkt;9;9;0
22/04/2019;06:00;21;12;9;Leicht bewölkt;10;9;0
22/04/2019;07:00;47;22;25;Leicht bewölkt;11;11;0
22/04/2019;08:00;83;49;34;Bedeckt;13;13;0
22/04/2019;09:00;167;85;82;Bedeckt;15;15;0
22/04/2019;10:00;244;132;112;Bedeckt;16;16;0
22/04/2019;11:00;314;166;148;Leicht bewölkt;18;18;0
22/04/2019;12:00;413;205;208;Leicht bewölkt;19;19;0
22/04/2019;13:00;432;221;211;Leicht bewölkt;20;20;0
22/04/2019;14:00;501;260;241;Leicht bewölkt;20;20;0
22/04/2019;15:00;473;261;212;Leicht bewölkt;20;20;0
22/04/2019;16:00;474;232;242;Leicht bewölkt;20;20;0
22/04/2019;17:00;466;230;236;Leicht bewölkt;19;19;0
22/04/2019;18:00;414;206;208;Leicht bewölkt;18;18;0
22/04/2019;19:00;343;174;169;Leicht bewölkt;16;16;0
22/04/2019;20:00;212;112;100;Leicht bewölkt;15;15;0
22/04/2019;21:00;184;75;109;Leicht bewölkt;13;13;0
22/04/2019;22:00;117;55;62;Leicht bewölkt;13;12;0
22/04/2019;23:00;79;30;49;Leicht bewölkt;12;11;0
23/04/2019;00:00;45;16;29;Leicht bewölkt;11;11;0
23/04/2019;01:00;18;10;8;Leicht bewölkt;10;10;0
23/04/2019;02:00;10;6;4;Leicht bewölkt;10;10;0
23/04/2019;03:00;10;3;7;Leicht bewölkt;9;10;0
23/04/2019;04:00;4;3;1;Leicht bewölkt;10;10;0
23/04/2019;05:00;45;28;17;Leicht bewölkt;10;10;0
23/04/2019;06:00;157;105;52;Leicht bewölkt;10;10;0
23/04/2019;07:00;604;388;216;Leicht bewölkt;12;12;0
23/04/2019;08:00;605;380;225;Bewölkt;13;13;0
23/04/2019;09:00;641;394;247;Bewölkt;15;15;0
23/04/2019;10:00;513;289;224;Bewölkt;16;16;0
23/04/2019;11:00;667;324;343;Leicht bewölkt;17;17;0
23/04/2019;12:00;598;274;324;Leicht bewölkt;18;18;0
23/04/2019;13:00;712;402;310;Leicht bewölkt;19;19;0
23/04/2019;14:00;636;337;299;Leicht bewölkt;19;19;0
23/04/2019;15:00;783;378;405;Leicht bewölkt;19;19;0
23/04/2019;16:00;770;355;415;Leicht bewölkt;18;18;0
23/04/2019;17:00;998;436;562;Leicht bewölkt;17;17;0
23/04/2019;18:00;878;421;457;Leicht bewölkt;16;16;0
23/04/2019;19:00;708;336;372;Leicht bewölkt;15;14;0
23/04/2019;20:00;463;175;288;Leicht bewölkt;14;13;0
23/04/2019;21:00;347;132;215;Leicht bewölkt;13;12;0
23/04/2019;22:00;273;106;167;Leicht bewölkt;12;11;0
23/04/2019;23:00;137;58;79;Leicht bewölkt;11;11;0
24/04/2019;00:00;72;26;46;Leicht bewölkt;10;10;0
24/04/2019;01:00;37;11;26;Leicht bewölkt;10;10;0
24/04/2019;02:00;15;7;8;Leicht bewölkt;10;9;0
24/04/2019;03:00;39;6;33;Leicht bewölkt;9;9;0
24/04/2019;04:00;6;3;3;Leicht bewölkt;10;10;0
24/04/2019;05:00;60;33;27;Leicht bewölkt;11;11;0
24/04/2019;06:00;174;108;66;Leicht bewölkt;11;11;0
24/04/2019;07:00;708;465;243;Leicht bewölkt;13;13;0
24/04/2019;08:00;654;377;277;Leicht bewölkt;15;15;0
24/04/2019;09:00;733;429;304;Leicht bewölkt;17;17;0
24/04/2019;10:00;527;282;245;Leicht bewölkt;18;18;0
24/04/2019;11:00;684;348;336;Leicht bewölkt;20;20;0
24/04/2019;12:00;734;326;408;Leicht bewölkt;21;21;0
24/04/2019;13:00;758;421;337;Leicht bewölkt;21;21;0
24/04/2019;14:00;718;334;384;Leicht bewölkt;22;22;0
24/04/2019;15:00;850;458;392;Leicht bewölkt;22;22;0
24/04/2019;16:00;932;452;480;Leicht bewölkt;21;21;0
24/04/2019;17:00;991;484;507;Leicht bewölkt;20;20;0
24/04/2019;18:00;888;414;474;Leicht bewölkt;20;20;0
24/04/2019;19:00;723;304;419;Leicht bewölkt;18;18;0
24/04/2019;20:00;527;223;304;Leicht bewölkt;17;17;0
24/04/2019;21:00;321;143;178;Leicht bewölkt;16;16;0
24/04/2019;22:00;262;113;149;Leicht bewölkt;14;14;0
24/04/2019;23:00;204;87;117;Leicht bewölkt;12;11;0
25/04/2019;00:00;97;25;72;Leicht bewölkt;10;9;0
25/04/2019;01:00;62;14;48;Leicht bewölkt;9;8;0
25/04/2019;02:00;18;10;8;Leicht bewölkt;9;7;0
25/04/2019;03:00;22;11;11;Leicht bewölkt;8;7;0
25/04/2019;04:00;19;15;4;Leicht bewölkt;8;8;0
25/04/2019;05:00;49;26;23;Leicht bewölkt;9;9;0
25/04/2019;06:00;148;89;59;Leicht bewölkt;10;10;0
25/04/2019;07:00;603;387;216;Leicht bewölkt;12;12;0
25/04/2019;08:00;636;397;239;Leicht bewölkt;14;14;0
25/04/2019;09:00;653;391;262;Leicht bewölkt;16;16;0
25/04/2019;10:00;470;287;183;Leicht bewölkt;17;17;0
25/04/2019;11:00;701;365;336;Bedeckt;19;19;0
25/04/2019;12:00;661;301;360;Bedeckt;20;20;0
25/04/2019;13:00;760;368;392;Bedeckt;21;21;0
25/04/2019;14:00;706;351;355;Leicht bewölkt;21;21;0
25/04/2019;15:00;847;453;394;Leicht bewölkt;21;21;0
25/04/2019;16:00;900;395;505;Leicht bewölkt;20;20;0
25/04/2019;17:00;989;457;532;Leicht bewölkt;20;20;0
25/04/2019;18:00;838;385;453;Leicht bewölkt;19;19;0
25/04/2019;19:00;699;304;395;Leicht bewölkt;18;18;0
25/04/2019;20:00;512;189;323;Leicht bewölkt;17;17;0
25/04/2019;21:00;338;129;209;Leicht bewölkt;16;16;0
25/04/2019;22:00;313;113;200;Leicht bewölkt;14;14;0
25/04/2019;23:00;190;74;116;Leicht bewölkt;13;13;0
26/04/2019;00:00;104;43;61;Leicht bewölkt;12;12;0
26/04/2019;01:00;54;16;38;Leicht bewölkt;10;10;0
26/04/2019;02:00;14;7;7;Leicht bewölkt;9;8;0
26/04/2019;03:00;7;3;4;Leicht bewölkt;8;7;0
26/04/2019;04:00;5;4;1;Leicht bewölkt;8;7;0
26/04/2019;05:00;43;27;16;Leichter Nebel;8;6;0
26/04/2019;06:00;118;74;44;Leichter Nebel;8;6;0
26/04/2019;07:00;317;194;123;Leichter Nebel;7;5;0
26/04/2019;08:00;378;261;117;Stellenweiser Regenfall;7;4;0
26/04/2019;09:00;324;193;131;Stellenweiser Regenfall;7;3;1
26/04/2019;10:00;238;136;102;Stellenweiser Regenfall;6;3;0
26/04/2019;11:00;235;130;105;Mäßiger Regenfall;6;3;1
26/04/2019;12:00;268;102;166;Mäßiger Regenfall;6;3;1
26/04/2019;13:00;331;132;199;Mäßiger Regenfall;7;4;1
26/04/2019;14:00;251;122;129;Starker Regenfall;7;4;1
26/04/2019;15:00;288;130;158;Starker Regenfall;7;5;1
26/04/2019;16:00;402;215;187;Starker Regenfall;7;5;0
26/04/2019;17:00;442;227;215;Mäßiger Regenfall;7;5;0
26/04/2019;18:00;425;194;231;Mäßiger Regenfall;8;6;0
26/04/2019;19:00;380;175;205;Mäßiger Regenfall;7;5;0
26/04/2019;20:00;306;151;155;Leicht bewölkt;7;5;0
26/04/2019;21:00;200;104;96;Leicht bewölkt;6;5;0
26/04/2019;22:00;164;77;87;Leicht bewölkt;6;5;0
26/04/2019;23:00;149;54;95;Leicht bewölkt;6;4;0
27/04/2019;00:00;118;38;80;Leicht bewölkt;6;4;0
27/04/2019;01:00;80;24;56;Leicht bewölkt;5;3;0
27/04/2019;02:00;67;21;46;Bedeckt;5;3;0
27/04/2019;03:00;34;9;25;Bedeckt;4;2;0
27/04/2019;04:00;23;4;19;Bedeckt;5;3;0
27/04/2019;05:00;25;15;10;Leichter Regenschauer;5;3;0
27/04/2019;06:00;34;22;12;Leichter Regenschauer;6;4;0
27/04/2019;07:00;65;33;32;Leichter Regenschauer;7;5;0
27/04/2019;08:00;152;81;71;Stellenweiser Regenfall;8;6;0
27/04/2019;09:00;302;188;114;Stellenweiser Regenfall;10;7;0
27/04/2019;10:00;345;213;132;Stellenweiser Regenfall;10;8;0
27/04/2019;11:00;301;173;128;Bedeckt;11;9;0
27/04/2019;12:00;412;221;191;Bedeckt;12;10;0
27/04/2019;13:00;433;245;188;Bedeckt;11;9;0
27/04/2019;14:00;397;192;205;Leicht bewölkt;11;9;0
27/04/2019;15:00;425;178;247;Leicht bewölkt;11;9;0
27/04/2019;16:00;365;180;185;Leicht bewölkt;10;8;0
27/04/2019;17:00;328;142;186;Stellenweiser Regenfall;9;7;0
27/04/2019;18:00;275;102;173;Stellenweiser Regenfall;9;6;0
27/04/2019;19:00;268;142;126;Stellenweiser Regenfall;8;5;0
27/04/2019;20:00;252;121;131;Bewölkt;7;4;0
27/04/2019;21:00;202;108;94;Bewölkt;6;3;0
27/04/2019;22:00;127;54;73;Bewölkt;6;3;0
27/04/2019;23:00;120;50;70;Stellenweiser Nieselregen;5;2;0
28/04/2019;00:00;106;33;73;Stellenweiser Nieselregen;5;2;0
28/04/2019;01:00;79;26;53;Stellenweiser Nieselregen;5;1;0
28/04/2019;02:00;74;15;59;Stellenweiser Nieselregen;4;1;0
28/04/2019;03:00;38;13;25;Stellenweiser Nieselregen;4;1;0
28/04/2019;04:00;15;11;4;Stellenweiser Nieselregen;4;1;0
28/04/2019;05:00;26;15;11;Stellenweiser Regenfall;4;2;0
28/04/2019;06:00;26;16;10;Stellenweiser Regenfall;4;2;0
28/04/2019;07:00;32;15;17;Stellenweiser Regenfall;5;3;0
28/04/2019;08:00;52;26;26;Stellenweiser Regenfall;6;4;0
28/04/2019;09:00;179;102;77;Stellenweiser Regenfall;6;5;0
28/04/2019;10:00;161;91;70;Stellenweiser Regenfall;7;5;0
28/04/2019;11:00;203;102;101;Leichter Regenschauer;8;6;0
28/04/2019;12:00;188;87;101;Leichter Regenschauer;8;6;0
28/04/2019;13:00;267;134;133;Leichter Regenschauer;8;6;0
28/04/2019;14:00;237;129;108;Nieselregen;9;7;0
28/04/2019;15:00;334;156;178;Nieselregen;9;7;0
28/04/2019;16:00;282;127;155;Nieselregen;8;6;0
28/04/2019;17:00;306;158;148;Stellenweiser Regenfall;8;6;0
28/04/2019;18:00;306;151;155;Stellenweiser Regenfall;7;5;0
28/04/2019;19:00;247;124;123;Stellenweiser Regenfall;6;4;0
28/04/2019;20:00;186;85;101;Leicht bewölkt;5;4;0
28/04/2019;21:00;129;48;81;Leicht bewölkt;4;3;0
28/04/2019;22:00;104;40;64;Leicht bewölkt;4;3;0
28/04/2019;23:00;66;25;41;Bewölkt;3;3;0
29/04/2019;00:00;26;17;9;Bewölkt;3;3;0
29/04/2019;01:00;16;8;8;Bewölkt;3;2;0
29/04/2019;02:00;11;2;9;Stellenweiser Regenfall;2;2;0
29/04/2019;03:00;5;4;1;Stellenweiser Regenfall;2;1;0
29/04/2019;04:00;4;2;2;Stellenweiser Regenfall;3;2;0
29/04/2019;05:00;50;31;19;Leichter Nebel;3;2;0
29/04/2019;06:00;147;91;56;Leichter Nebel;4;3;0
29/04/2019;07:00;972;648;324;Leichter Nebel;5;4;0
29/04/2019;08:00;646;361;285;Bewölkt;6;6;0
29/04/2019;09:00;682;457;225;Bewölkt;8;7;0
29/04/2019;10:00;411;240;171;Bewölkt;9;8;0
29/04/2019;11:00;512;242;270;Leicht bewölkt;9;8;0
29/04/2019;12:00;666;271;395;Leicht bewölkt;10;9;0
29/04/2019;13:00;795;331;464;Leicht bewölkt;10;9;0
29/04/2019;14:00;462;217;245;Stellenweiser Regenfall;10;9;0
29/04/2019;15:00;872;406;466;Stellenweiser Regenfall;11;10;0
29/04/2019;16:00;690;340;350;Stellenweiser Regenfall;10;9;0
29/04/2019;17:00;792;311;481;Leichter Regenschauer;10;9;0
29/04/2019;18:00;755;345;410;Leichter Regenschauer;9;9;0
29/04/2019;19:00;592;265;327;Leichter Regenschauer;9;8;0
29/04/2019;20:00;395;172;223;Bedeckt;8;7;0
29/04/2019;21:00;276;104;172;Bedeckt;7;7;0
29/04/2019;22:00;214;67;147;Bedeckt;7;6;0
29/04/2019;23:00;126;58;68;Leichter Regenfall;7;6;0
30/04/2019;00:00;44;19;25;Leichter Regenfall;6;5;0
30/04/2019;01:00;37;5;32;Leichter Regenfall;6;5;0
30/04/2019;02:00;13;9;4;Bedeckt;6;5;0
30/04/2019;03:00;5;2;3;Bedeckt;6;5;0
30/04/2019;04:00;7;5;2;Bedeckt;6;5;0
30/04/2019;05:00;38;24;14;Nieselregen;6;5;0
30/04/2019;06:00;141;87;54;Nieselregen;6;5;0
30/04/2019;07:00;894;613;281;Nieselregen;7;6;0
30/04/2019;08:00;685;402;283;Bedeckt;7;6;0
30/04/2019;09:00;623;393;230;Bedeckt;7;6;0
30/04/2019;10:00;328;189;139;Bedeckt;8;8;0
30/04/2019;11:00;526;240;286;Stellenweiser Regenfall;10;9;0
30/04/2019;12:00;496;189;307;Stellenweiser Regenfall;11;11;0
30/04/2019;13:00;766;357;409;Stellenweiser Regenfall;11;11;0
30/04/2019;14:00;470;201;269;Nieselregen;12;11;0
30/04/2019;15:00;845;352;493;Nieselregen;13;12;0
30/04/2019;16:00;715;349;366;Nieselregen;12;11;0
30/04/2019;17:00;966;428;538;Leichter Regenschauer;11;11;0
30/04/2019;18:00;784;380;404;Leichter Regenschauer;11;10;0
30/04/2019;19:00;669;285;384;Leichter Regenschauer;9;9;0
30/04/2019;20:00;525;287;238;Leicht bewölkt;8;8;0
30/04/2019;21:00;397;230;167;Leicht bewölkt;7;7;0
30/04/2019;22:00;317;157;160;Leicht bewölkt;6;6;0
30/04/2019;23:00;271;115;156;Leicht bewölkt;6;6;0
01/05/2019;00:00;229;72;157;Leicht bewölkt;6;6;0
01/05/2019;01:00;190;45;145;Leicht bewölkt;5;5;0
01/05/2019;02:00;136;48;88;Leicht bewölkt;5;5;0
01/05/2019;03:00;94;27;67;Leicht bewölkt;5;5;0
01/05/2019;04:00;40;14;26;Leicht bewölkt;6;6;0
01/05/2019;05:00;37;28;9;Leicht bewölkt;7;7;0
01/05/2019;06:00;36;17;19;Leicht bewölkt;7;7;0
01/05/2019;07:00;56;33;23;Leicht bewölkt;9;9;0
01/05/2019;08:00;115;50;65;Leicht bewölkt;11;11;0
01/05/2019;09:00;203;100;103;Leicht bewölkt;12;12;0
01/05/2019;10:00;416;196;220;Leicht bewölkt;14;14;0
01/05/2019;11:00;476;198;278;Leicht bewölkt;15;15;0
01/05/2019;12:00;506;234;272;Leicht bewölkt;16;16;0
01/05/2019;13:00;591;265;326;Leicht bewölkt;16;16;0
01/05/2019;14:00;597;299;298;Leicht bewölkt;17;17;0
01/05/2019;15:00;571;326;245;Leicht bewölkt;17;17;0
01/05/2019;16:00;630;305;325;Leicht bewölkt;16;16;0
01/05/2019;17:00;705;369;336;Leicht bewölkt;15;15;0
01/05/2019;18:00;596;326;270;Leicht bewölkt;14;14;0
01/05/2019;19:00;494;238;256;Leicht bewölkt;13;13;0
01/05/2019;20:00;483;254;229;Leicht bewölkt;11;11;0
01/05/2019;21:00;283;132;151;Leicht bewölkt;10;10;0
01/05/2019;22:00;198;69;129;Leicht bewölkt;9;9;0
01/05/2019;23:00;178;70;108;Leicht bewölkt;8;8;0
02/05/2019;00:00;49;19;30;Leicht bewölkt;8;7;0
02/05/2019;01:00;30;16;14;Leicht bewölkt;7;7;0
02/05/2019;02:00;10;4;6;Leicht bewölkt;7;6;0
02/05/2019;03:00;5;3;2;Leicht bewölkt;6;6;0
02/05/2019;04:00;5;5;0;Leicht bewölkt;7;6;0
02/05/2019;05:00;50;32;18;Leicht bewölkt;8;7;0
02/05/2019;06:00;143;100;43;Leicht bewölkt;8;8;0
02/05/2019;07:00;1009;640;369;Leicht bewölkt;10;9;0
02/05/2019;08:00;767;469;298;Leicht bewölkt;12;11;0
02/05/2019;09:00;807;487;320;Leicht bewölkt;13;13;0
02/05/2019;10:00;483;287;196;Leicht bewölkt;14;14;0
02/05/2019;11:00;705;348;357;Leicht bewölkt;16;16;0
02/05/2019;12:00;615;273;342;Leicht bewölkt;17;17;0
02/05/2019;13:00;883;381;502;Leicht bewölkt;17;16;0
02/05/2019;14:00;659;314;345;Leicht bewölkt;16;16;0
02/05/2019;15:00;1025;490;535;Leicht bewölkt;16;15;0
02/05/2019;16:00;827;384;443;Leicht bewölkt;14;14;0
02/05/2019;17:00;883;323;560;Leichter Regenschauer;13;13;0
02/05/2019;18:00;805;364;441;Leichter Regenschauer;12;12;0
02/05/2019;19:00;531;239;292;Leichter Regenschauer;11;10;0
02/05/2019;20:00;399;182;217;Mäßiger Regenfall;10;9;0
02/05/2019;21:00;226;96;130;Mäßiger Regenfall;10;8;0
02/05/2019;22:00;215;63;152;Mäßiger Regenfall;9;8;0
02/05/2019;23:00;102;43;59;Leichter Regenschauer;9;7;0
03/05/2019;00:00;49;14;35;Leichter Regenschauer;9;7;0
03/05/2019;01:00;24;12;12;Leichter Regenschauer;9;7;0
03/05/2019;02:00;11;5;6;Bedeckt;9;7;0
03/05/2019;03:00;7;5;2;Bedeckt;9;7;0
03/05/2019;04:00;7;6;1;Bedeckt;8;7;0
03/05/2019;05:00;44;32;12;Nieselregen;8;7;0
03/05/2019;06:00;88;56;32;Nieselregen;8;7;0
03/05/2019;07:00;660;394;266;Nieselregen;8;7;0
03/05/2019;08:00;559;355;204;Bedeckt;9;7;0
03/05/2019;09:00;489;312;177;Bedeckt;9;8;0
03/05/2019;10:00;338;205;133;Bedeckt;10;9;0
03/05/2019;11:00;404;181;223;Nieselregen;11;10;0
03/05/2019;12:00;518;258;260;Nieselregen;11;11;0
03/05/2019;13:00;646;237;409;Nieselregen;12;11;0
03/05/2019;14:00;418;197;221;Stellenweiser leichter Regenfall;12;12;0
03/05/2019;15:00;475;216;259;Stellenweiser leichter Regenfall;13;12;0
03/05/2019;16:00;538;252;286;Stellenweiser leichter Regenfall;12;12;0
03/05/2019;17:00;561;256;305;Stellenweiser Regenfall;12;12;0
03/05/2019;18:00;543;253;290;Stellenweiser Regenfall;11;11;0
03/05/2019;19:00;426;210;216;Stellenweiser Regenfall;10;10;0
03/05/2019;20:00;345;186;159;Mäßiger bis starker Regenschauer;9;9;0
03/05/2019;21:00;275;134;141;Mäßiger bis starker Regenschauer;8;8;0
03/05/2019;22:00;215;74;141;Mäßiger bis starker Regenschauer;7;7;0
03/05/2019;23:00;192;54;138;Leichter Regenschauer;6;6;0
04/05/2019;00:00;155;33;122;Leichter Regenschauer;6;5;0
04/05/2019;01:00;92;35;57;Leichter Regenschauer;5;5;0
04/05/2019;02:00;68;27;41;Stellenweiser Regenfall;5;4;0
04/05/2019;03:00;19;4;15;Stellenweiser Regenfall;4;3;0
04/05/2019;04:00;21;12;9;Stellenweiser Regenfall;5;4;0
04/05/2019;05:00;26;20;6;Leicht bewölkt;5;4;0
04/05/2019;06:00;32;15;17;Leicht bewölkt;6;5;0
04/05/2019;07:00;75;41;34;Leicht bewölkt;7;6;0
04/05/2019;08:00;216;129;87;Leichter Regenschauer;8;6;0
04/05/2019;09:00;345;209;136;Leichter Regenschauer;9;7;0
04/05/2019;10:00;380;221;159;Leichter Regenschauer;10;7;0
04/05/2019;11:00;437;226;211;Stellenweiser Regenfall;10;7;0
04/05/2019;12:00;438;223;215;Stellenweiser Regenfall;10;8;0
04/05/2019;13:00;347;178;169;Stellenweiser Regenfall;9;7;0
04/05/2019;14:00;376;179;197;Bedeckt;9;6;0
04/05/2019;15:00;377;180;197;Bedeckt;8;5;0
04/05/2019;16:00;250;120;130;Bedeckt;7;4;0
04/05/2019;17:00;227;76;151;Mäßiger Regenfall;6;3;1
04/05/2019;18:00;230;89;141;Mäßiger Regenfall;5;1;1
04/05/2019;19:00;168;74;94;Mäßiger Regenfall;4;1;0
04/05/2019;20:00;149;81;68;Mäßiger bis starker Eisregen;3;0;0
04/05/2019;21:00;120;60;60;Mäßiger bis starker Eisregen;3;-1;1
04/05/2019;22:00;85;34;51;Mäßiger bis starker Eisregen;2;-1;0
04/05/2019;23:00;102;46;56;Starker Schneefall;2;-1;0
05/05/2019;00:00;63;24;39;Starker Schneefall;2;-2;1
05/05/2019;01:00;73;25;48;Starker Schneefall;1;-2;0
05/05/2019;02:00;26;12;14;Starker Schneefall;1;-2;0
05/05/2019;03:00;31;12;19;Starker Schneefall;1;-2;0
05/05/2019;04:00;16;1;15;Starker Schneefall;1;-2;0
05/05/2019;05:00;18;12;6;Starker Schneefall;2;-2;0
05/05/2019;06:00;21;14;7;Starker Schneefall;2;-2;0
05/05/2019;07:00;23;12;11;Starker Schneefall;2;-2;0
05/05/2019;08:00;44;15;29;Starker Schneefall;3;-1;0
05/05/2019;09:00;137;69;68;Starker Schneefall;3;-1;0
05/05/2019;10:00;147;93;54;Starker Schneefall;4;0;0
05/05/2019;11:00;139;86;53;Mäßige bis starke Schneefälle;5;1;0
05/05/2019;12:00;216;101;115;Mäßige bis starke Schneefälle;5;2;0
05/05/2019;13:00;221;100;121;Mäßige bis starke Schneefälle;6;3;0
05/05/2019;14:00;266;138;128;Leichter Regenschauer;6;4;0
05/05/2019;15:00;287;158;129;Leichter Regenschauer;7;4;0
05/05/2019;16:00;292;133;159;Leichter Regenschauer;6;4;0
05/05/2019;17:00;318;144;174;Leichter Regenschauer;6;5;0
05/05/2019;18:00;268;113;155;Leichter Regenschauer;6;5;0
05/05/2019;19:00;202;102;100;Leichter Regenschauer;5;4;0
05/05/2019;20:00;152;77;75;Leichter Regenschauer;3;3;0
05/05/2019;21:00;112;44;68;Leichter Regenschauer;2;2;0
05/05/2019;22:00;132;48;84;Leichter Regenschauer;2;1;0
05/05/2019;23:00;69;21;48;Stellenweiser Regenfall;1;1;0
06/05/2019;00:00;36;17;19;Stellenweiser Regenfall;0;0;0
06/05/2019;01:00;6;3;3;Stellenweiser Regenfall;0;0;0
06/05/2019;02:00;10;3;7;Stellenweiser Eisregen;0;-1;0
06/05/2019;03:00;1;0;1;Stellenweiser Eisregen;0;-1;0
06/05/2019;04:00;7;4;3;Stellenweiser Eisregen;0;0;0
06/05/2019;05:00;60;41;19;Bewölkt;1;1;0
06/05/2019;06:00;153;108;45;Bewölkt;2;1;0
06/05/2019;07:00;958;622;336;Bewölkt;4;4;0
06/05/2019;08:00;715;448;267;Bewölkt;6;6;0
06/05/2019;09:00;688;419;269;Bewölkt;8;8;0
06/05/2019;10:00;447;239;208;Bewölkt;9;9;0
06/05/2019;11:00;558;268;290;Leicht bewölkt;11;11;0
06/05/2019;12:00;619;262;357;Leicht bewölkt;12;12;0
06/05/2019;13:00;858;357;501;Leicht bewölkt;12;12;0
06/05/2019;14:00;519;255;264;Leicht bewölkt;12;12;0
06/05/2019;15:00;789;380;409;Leicht bewölkt;12;11;0
06/05/2019;16:00;797;383;414;Leicht bewölkt;11;11;0
06/05/2019;17:00;906;385;521;Stellenweiser Regenfall;10;10;0
06/05/2019;18:00;812;378;434;Stellenweiser Regenfall;9;9;0
06/05/2019;19:00;647;263;384;Stellenweiser Regenfall;8;8;0
06/05/2019;20:00;420;184;236;Leicht bewölkt;7;7;0
06/05/2019;21:00;285;110;175;Leicht bewölkt;6;6;0
06/05/2019;22:00;220;84;136;Leicht bewölkt;5;5;0
06/05/2019;23:00;125;57;68;Stellenweiser Regenfall;4;3;0
07/05/2019;00:00;47;22;25;Stellenweiser Regenfall;3;2;0
07/05/2019;01:00;25;10;15;Stellenweiser Regenfall;2;1;0
07/05/2019;02:00;12;6;6;Stellenweiser Regenfall;2;1;0
07/05/2019;03:00;9;5;4;Stellenweiser Regenfall;1;0;0
07/05/2019;04:00;9;7;2;Stellenweiser Regenfall;2;1;0
07/05/2019;05:00;36;24;12;Leicht bewölkt;3;2;0
07/05/2019;06:00;180;119;61;Leicht bewölkt;4;4;0
07/05/2019;07:00;1079;719;360;Leicht bewölkt;6;6;0
07/05/2019;08:00;792;446;346;Leicht bewölkt;8;8;0
07/05/2019;09:00;797;481;316;Leicht bewölkt;10;10;0
07/05/2019;10:00;465;267;198;Leicht bewölkt;12;12;0
07/05/2019;11:00;618;294;324;Leicht bewölkt;13;13;0
07/05/2019;12:00;625;263;362;Leicht bewölkt;15;15;0
07/05/2019;13:00;904;390;514;Leicht bewölkt;15;15;0
07/05/2019;14:00;592;265;327;Leicht bewölkt;16;16;0
07/05/2019;15:00;1030;496;534;Leicht bewölkt;16;16;0
07/05/2019;16:00;926;445;481;Leicht bewölkt;15;15;0
07/05/2019;17:00;1142;528;614;Leicht bewölkt;14;14;0
07/05/2019;18:00;948;416;532;Leicht bewölkt;12;12;0
07/05/2019;19:00;867;372;495;Leicht bewölkt;11;11;0
07/05/2019;20:00;515;233;282;Leicht bewölkt;9;9;0
07/05/2019;21:00;323;137;186;Leicht bewölkt;8;7;0
07/05/2019;22:00;273;87;186;Leicht bewölkt;7;6;0
07/05/2019;23:00;207;83;124;Leicht bewölkt;6;5;0
08/05/2019;00:00;70;25;45;Leicht bewölkt;5;4;0
08/05/2019;01:00;49;19;30;Leicht bewölkt;6;5;0
08/05/2019;02:00;10;2;8;Leicht bewölkt;6;5;0
08/05/2019;03:00;2;1;1;Leicht bewölkt;6;5;0
08/05/2019;04:00;9;7;2;Leicht bewölkt;7;6;0
08/05/2019;05:00;50;27;23;Bewölkt;8;7;0
08/05/2019;06:00;153;89;64;Bewölkt;9;8;0
08/05/2019;07:00;1070;693;377;Bewölkt;9;9;0
08/05/2019;08:00;671;419;252;Stellenweiser Regenfall;10;10;0
08/05/2019;09:00;579;362;217;Stellenweiser Regenfall;11;11;0
08/05/2019;10:00;314;164;150;Stellenweiser Regenfall;12;12;0
08/05/2019;11:00;489;228;261;Stellenweiser Nieselregen;13;13;0
08/05/2019;12:00;539;238;301;Stellenweiser Nieselregen;14;14;0
08/05/2019;13:00;777;381;396;Stellenweiser Nieselregen;14;14;0
08/05/2019;14:00;519;239;280;Leicht bewölkt;14;14;0
08/05/2019;15:00;613;251;362;Leicht bewölkt;14;14;0
08/05/2019;16:00;614;276;338;Leicht bewölkt;13;12;0
08/05/2019;17:00;767;309;458;Stellenweiser Nieselregen;12;11;0
08/05/2019;18:00;500;217;283;Stellenweiser Nieselregen;11;9;0
08/05/2019;19:00;367;143;224;Stellenweiser Nieselregen;10;8;0
08/05/2019;20:00;298;129;169;Bedeckt;10;7;0
08/05/2019;21:00;176;90;86;Bedeckt;9;7;0
08/05/2019;22:00;144;57;87;Bedeckt;9;7;0
08/05/2019;23:00;96;43;53;Teilweise mäßiger Regenfall;9;6;0
09/05/2019;00:00;50;13;37;Teilweise mäßiger Regenfall;8;6;0
09/05/2019;01:00;30;14;16;Teilweise mäßiger Regenfall;8;6;0
09/05/2019;02:00;13;5;8;Leichter Regenfall;7;6;0
09/05/2019;03:00;11;8;3;Leichter Regenfall;7;5;0
09/05/2019;04:00;5;5;0;Leichter Regenfall;7;6;0
09/05/2019;05:00;50;32;18;Leicht bewölkt;8;6;0
09/05/2019;06:00;148;90;58;Leicht bewölkt;8;7;0
09/05/2019;07:00;999;634;365;Leicht bewölkt;9;8;0
09/05/2019;08:00;759;441;318;Leicht bewölkt;10;8;0
09/05/2019;09:00;693;442;251;Leicht bewölkt;11;9;0
09/05/2019;10:00;383;216;167;Leicht bewölkt;11;10;0
09/05/2019;11:00;518;251;267;Stellenweiser Nieselregen;12;10;0
09/05/2019;12:00;544;227;317;Stellenweiser Nieselregen;12;11;0
09/05/2019;13:00;843;339;504;Stellenweiser Nieselregen;12;10;0
09/05/2019;14:00;531;253;278;Stellenweise Gewitter und Niederschläge;13;10;0
09/05/2019;15:00;899;375;524;Stellenweise Gewitter und Niederschläge;13;10;0
09/05/2019;16:00;749;382;367;Stellenweise Gewitter und Niederschläge;12;10;0
09/05/2019;17:00;858;373;485;Leichter Regenschauer;11;9;0
09/05/2019;18:00;810;377;433;Leichter Regenschauer;11;9;0
09/05/2019;19:00;571;288;283;Leichter Regenschauer;10;8;0
09/05/2019;20:00;444;204;240;Bedeckt;9;7;0
09/05/2019;21:00;315;122;193;Bedeckt;9;6;0
09/05/2019;22:00;257;77;180;Bedeckt;8;6;0
09/05/2019;23:00;171;63;108;Leichter Regenschauer;8;6;0
10/05/2019;00:00;101;38;63;Leichter Regenschauer;8;6;0
10/05/2019;01:00;44;16;28;Leichter Regenschauer;8;6;0
10/05/2019;02:00;38;21;17;Leichter Regenschauer;8;6;0
10/05/2019;03:00;29;27;2;Leichter Regenschauer;8;6;0
10/05/2019;04:00;40;35;5;Leichter Regenschauer;8;6;0
10/05/2019;05:00;43;31;12;Leichter Regenschauer;8;7;0
10/05/2019;06:00;131;84;47;Leichter Regenschauer;8;7;0
10/05/2019;07:00;765;473;292;Leichter Regenschauer;9;7;0
10/05/2019;08:00;610;373;237;Mäßiger Regenfall;10;8;0
10/05/2019;09:00;583;342;241;Mäßiger Regenfall;10;9;0
10/05/2019;10:00;426;235;191;Mäßiger Regenfall;11;10;0
10/05/2019;11:00;538;275;263;Nieselregen;12;11;0
10/05/2019;12:00;674;312;362;Nieselregen;14;13;0
10/05/2019;13:00;815;315;500;Nieselregen;14;14;0
10/05/2019;14:00;652;349;303;Leicht bewölkt;15;15;0
10/05/2019;15:00;618;299;319;Leicht bewölkt;16;16;0
10/05/2019;16:00;649;296;353;Leicht bewölkt;15;15;0
10/05/2019;17:00;647;300;347;Stellenweiser Regenfall;15;15;0
10/05/2019;18:00;613;279;334;Stellenweiser Regenfall;14;14;0
10/05/2019;19:00;512;255;257;Stellenweiser Regenfall;13;13;0
10/05/2019;20:00;380;180;200;Leicht bewölkt;12;11;0
10/05/2019;21:00;234;116;118;Leicht bewölkt;11;10;0
10/05/2019;22:00;226;78;148;Leicht bewölkt;10;9;0
10/05/2019;23:00;212;63;149;Leicht bewölkt;9;8;0
11/05/2019;00:00;133;60;73;Leicht bewölkt;8;7;0
11/05/2019;01:00;100;37;63;Leicht bewölkt;9;7;0
11/05/2019;02:00;53;11;42;Leicht bewölkt;9;7;0
11/05/2019;03:00;42;20;22;Leicht bewölkt;9;7;0
11/05/2019;04:00;17;11;6;Leicht bewölkt;9;8;0
11/05/2019;05:00;28;17;11;Leichter Regenschauer;10;9;0
11/05/2019;06:00;22;11;11;Leichter Regenschauer;11;9;0
11/05/2019;07:00;61;35;26;Leichter Regenschauer;12;10;0
11/05/2019;08:00;174;96;78;Leicht bewölkt;13;11;0
11/05/2019;09:00;255;155;100;Leicht bewölkt;14;12;0
11/05/2019;10:00;257;149;108;Leicht bewölkt;14;12;0
11/05/2019;11:00;390;202;188;Leichter Regenschauer;14;13;0
11/05/2019;12:00;236;140;96;Leichter Regenschauer;15;13;0
11/05/2019;13:00;344;172;172;Leichter Regenschauer;14;12;0
11/05/2019;14:00;367;213;154;Bedeckt;13;11;0
11/05/2019;15:00;387;185;202;Bedeckt;12;11;0
11/05/2019;16:00;289;120;169;Bedeckt;11;10;0
11/05/2019;17:00;297;141;156;Mäßiger bis starker Regenschauer;11;9;0
11/05/2019;18:00;341;147;194;Mäßiger bis starker Regenschauer;10;8;1
11/05/2019;19:00;298;149;149;Mäßiger bis starker Regenschauer;9;7;0
11/05/2019;20:00;200;103;97;Mäßiger bis starker Regenschauer;9;7;0
11/05/2019;21:00;166;71;95;Mäßiger bis starker Regenschauer;8;7;0
11/05/2019;22:00;106;47;59;Mäßiger bis starker Regenschauer;8;7;0
11/05/2019;23:00;125;45;80;Leichter Regenfall;8;7;0
12/05/2019;00:00;145;39;106;Leichter Regenfall;8;7;1
12/05/2019;01:00;131;26;105;Leichter Regenfall;7;6;0
12/05/2019;02:00;64;28;36;Mäßiger Regenfall;7;5;0
12/05/2019;03:00;63;21;42;Mäßiger Regenfall;7;4;1
12/05/2019;04:00;31;15;16;Mäßiger Regenfall;7;4;0
12/05/2019;05:00;20;13;7;Mäßiger Regenfall;7;4;0
12/05/2019;06:00;27;17;10;Mäßiger Regenfall;7;4;1
12/05/2019;07:00;33;15;18;Mäßiger Regenfall;7;5;0
12/05/2019;08:00;66;29;37;Mäßiger Regenfall;7;5;0
12/05/2019;09:00;147;75;72;Mäßiger Regenfall;8;6;0
12/05/2019;10:00;211;116;95;Mäßiger Regenfall;8;7;0
12/05/2019;11:00;256;133;123;Leichter Regenschauer;9;7;0
12/05/2019;12:00;237;108;129;Leichter Regenschauer;9;8;0
12/05/2019;13:00;280;150;130;Leichter Regenschauer;10;8;0
12/05/2019;14:00;361;179;182;Leichter Regenschauer;10;8;0
12/05/2019;15:00;332;169;163;Leichter Regenschauer;10;8;0
12/05/2019;16:00;345;155;190;Leichter Regenschauer;9;8;0
12/05/2019;17:00;326;126;200;Leichter Regenschauer;9;7;0
12/05/2019;18:00;277;133;144;Leichter Regenschauer;8;7;0
12/05/2019;19:00;195;95;100;Leichter Regenschauer;8;6;0
12/05/2019;20:00;152;67;85;Leichter Regenschauer;7;5;0
12/05/2019;21:00;107;38;69;Leichter Regenschauer;6;4;0
12/05/2019;22:00;103;40;63;Leichter Regenschauer;6;3;0
12/05/2019;23:00;58;25;33;Leicht bewölkt;5;2;0
13/05/2019;00:00;32;13;19;Leicht bewölkt;4;2;0
13/05/2019;01:00;14;9;5;Leicht bewölkt;4;1;0
13/05/2019;02:00;3;1;2;Leicht bewölkt;4;1;0
13/05/2019;03:00;5;3;2;Leicht bewölkt;4;0;0
13/05/2019;04:00;6;6;0;Leicht bewölkt;5;1;0
13/05/2019;05:00;57;36;21;Leicht bewölkt;5;2;0
13/05/2019;06:00;153;100;53;Leicht bewölkt;6;2;0
13/05/2019;07:00;1065;692;373;Leicht bewölkt;7;4;0
13/05/2019;08:00;704;404;300;Leicht bewölkt;9;5;0
13/05/2019;09:00;760;469;291;Leicht bewölkt;10;7;0
13/05/2019;10:00;481;268;213;Leicht bewölkt;11;8;0
13/05/2019;11:00;635;283;352;Leicht bewölkt;12;9;0
13/05/2019;12:00;635;272;363;Leicht bewölkt;13;10;0
13/05/2019;13:00;883;356;527;Leicht bewölkt;13;10;0
13/05/2019;14:00;556;289;267;Stellenweiser Regenfall;13;11;0
13/05/2019;15:00;947;423;524;Stellenweiser Regenfall;14;11;0
13/05/2019;16:00;718;337;381;Stellenweiser Regenfall;13;11;0
13/05/2019;17:00;888;406;482;Leicht bewölkt;12;10;0
13/05/2019;18:00;805;335;470;Leicht bewölkt;12;9;0
13/05/2019;19:00;605;264;341;Leicht bewölkt;10;8;0
13/05/2019;20:00;436;180;256;Leicht bewölkt;9;7;0
13/05/2019;21:00;284;117;167;Leicht bewölkt;8;5;0
13/05/2019;22:00;229;107;122;Leicht bewölkt;8;4;0
13/05/2019;23:00;141;69;72;Leicht bewölkt;7;3;0
14/05/2019;00:00;58;20;38;Leicht bewölkt;6;2;0
14/05/2019;01:00;13;8;5;Leicht bewölkt;5;2;0
14/05/2019;02:00;17;11;6;Leicht bewölkt;5;1;0
14/05/2019;03:00;4;3;1;Leicht bewölkt;5;1;0
14/05/2019;04:00;4;3;1;Leicht bewölkt;5;2;0
14/05/2019;05:00;43;31;12;Leicht bewölkt;6;2;0
14/05/2019;06:00;180;121;59;Leicht bewölkt;6;3;0
14/05/2019;07:00;1091;725;366;Leicht bewölkt;7;4;0
14/05/2019;08:00;808;483;325;Leicht bewölkt;9;6;0
14/05/2019;09:00;867;530;337;Leicht bewölkt;10;7;0
14/05/2019;10:00;504;286;218;Leicht bewölkt;11;8;0
14/05/2019;11:00;636;303;333;Leicht bewölkt;11;9;0
14/05/2019;12:00;684;314;370;Leicht bewölkt;12;10;0
14/05/2019;13:00;912;390;522;Leicht bewölkt;12;10;0
14/05/2019;14:00;647;277;370;Leicht bewölkt;12;10;0
14/05/2019;15:00;987;418;569;Leicht bewölkt;12;10;0
14/05/2019;16:00;881;445;436;Leicht bewölkt;12;9;0
14/05/2019;17:00;1077;490;587;Leicht bewölkt;11;8;0
14/05/2019;18:00;860;381;479;Leicht bewölkt;10;7;0
14/05/2019;19:00;768;356;412;Leicht bewölkt;9;6;0
14/05/2019;20:00;503;214;289;Leicht bewölkt;8;5;0
14/05/2019;21:00;353;148;205;Leicht bewölkt;6;4;0
14/05/2019;22:00;256;103;153;Leicht bewölkt;6;3;0
14/05/2019;23:00;146;47;99;Leicht bewölkt;5;2;0
15/05/2019;00:00;69;23;46;Leicht bewölkt;4;1;0
15/05/2019;01:00;31;8;23;Leicht bewölkt;4;0;0
15/05/2019;02:00;8;2;6;Leicht bewölkt;3;-1;0
15/05/2019;03:00;5;2;3;Leicht bewölkt;3;-1;0
15/05/2019;04:00;7;4;3;Leicht bewölkt;3;-1;0
15/05/2019;05:00;53;34;19;Leicht bewölkt;4;0;0
15/05/2019;06:00;179;113;66;Leicht bewölkt;4;0;0
15/05/2019;07:00;1214;788;426;Leicht bewölkt;6;2;0
15/05/2019;08:00;788;494;294;Leicht bewölkt;7;3;0
15/05/2019;09:00;756;458;298;Leicht bewölkt;8;5;0
15/05/2019;10:00;426;231;195;Leicht bewölkt;9;6;0
15/05/2019;11:00;634;289;345;Leicht bewölkt;10;8;0
15/05/2019;12:00;686;268;418;Leicht bewölkt;12;9;0
15/05/2019;13:00;895;378;517;Leicht bewölkt;12;10;0
15/05/2019;14:00;658;297;361;Leicht bewölkt;12;10;0
15/05/2019;15:00;849;383;466;Leicht bewölkt;13;11;0
15/05/2019;16:00;785;350;435;Leicht bewölkt;12;10;0
15/05/2019;17:00;1068;427;641;Leicht bewölkt;11;9;0
15/05/2019;18:00;826;360;466;Leicht bewölkt;11;9;0
15/05/2019;19:00;644;263;381;Leicht bewölkt;10;7;0
15/05/2019;20:00;519;257;262;Leicht bewölkt;8;6;0
15/05/2019;21:00;349;196;153;Leicht bewölkt;7;4;0
15/05/2019;22:00;297;138;159;Leicht bewölkt;6;4;0
15/05/2019;23:00;182;84;98;Leicht bewölkt;5;3;0
16/05/2019;00:00;106;25;81;Leicht bewölkt;4;2;0
16/05/2019;01:00;59;8;51;Leicht bewölkt;4;1;0
16/05/2019;02:00;17;7;10;Leicht bewölkt;3;1;0
16/05/2019;03:00;13;6;7;Leicht bewölkt;3;0;0
16/05/2019;04:00;9;6;3;Leicht bewölkt;3;1;0
16/05/2019;05:00;51;33;18;Leicht bewölkt;4;2;0
16/05/2019;06:00;162;105;57;Leicht bewölkt;4;2;0
16/05/2019;07:00;1128;762;366;Leicht bewölkt;6;4;0
16/05/2019;08:00;793;454;339;Leicht bewölkt;8;6;0
16/05/2019;09:00;705;394;311;Leicht bewölkt;9;8;0
16/05/2019;10:00;433;262;171;Leicht bewölkt;11;9;0
16/05/2019;11:00;631;328;303;Leicht bewölkt;12;11;0
16/05/2019;12:00;647;261;386;Leicht bewölkt;13;12;0
16/05/2019;13:00;926;363;563;Leicht bewölkt;14;13;0
16/05/2019;14:00;502;226;276;Bewölkt;14;13;0
16/05/2019;15:00;970;429;541;Bewölkt;14;14;0
16/05/2019;16:00;858;423;435;Bewölkt;14;13;0
16/05/2019;17:00;1075;469;606;Leicht bewölkt;13;12;0
16/05/2019;18:00;958;402;556;Leicht bewölkt;13;11;0
16/05/2019;19:00;687;345;342;Leicht bewölkt;12;11;0
16/05/2019;20:00;516;223;293;Leicht bewölkt;11;10;0
16/05/2019;21:00;323;142;181;Leicht bewölkt;10;10;0
16/05/2019;22:00;321;107;214;Leicht bewölkt;9;8;0
16/05/2019;23:00;184;66;118;Leicht bewölkt;8;7;0
17/05/2019;00:00;85;27;58;Leicht bewölkt;7;6;0
17/05/2019;01:00;44;21;23;Leicht bewölkt;6;5;0
17/05/2019;02:00;8;2;6;Leicht bewölkt;6;5;0
17/05/2019;03:00;7;5;2;Leicht bewölkt;5;4;0
17/05/2019;04:00;5;4;1;Leicht bewölkt;6;6;0
17/05/2019;05:00;54;38;16;Leicht bewölkt;7;7;0
17/05/2019;06:00;142;86;56;Leicht bewölkt;8;8;0
17/05/2019;07:00;979;646;333;Leicht bewölkt;10;10;0
17/05/2019;08:00;716;419;297;Leicht bewölkt;13;12;0
17/05/2019;09:00;746;455;291;Leicht bewölkt;15;15;0
17/05/2019;10:00;559;315;244;Leicht bewölkt;16;16;0
17/05/2019;11:00;730;343;387;Leicht bewölkt;18;18;0
17/05/2019;12:00;819;370;449;Leicht bewölkt;19;19;0
17/05/2019;13:00;994;379;615;Leicht bewölkt;19;19;0
17/05/2019;14:00;768;423;345;Leicht bewölkt;19;19;0
17/05/2019;15:00;722;373;349;Leicht bewölkt;19;19;0
17/05/2019;16:00;834;455;379;Leicht bewölkt;18;18;0
17/05/2019;17:00;955;474;481;Leicht bewölkt;16;16;0
17/05/2019;18:00;815;414;401;Leicht bewölkt;15;15;0
17/05/2019;19:00;740;400;340;Leicht bewölkt;14;14;0
17/05/2019;20:00;507;253;254;Stellenweiser Regenfall;13;12;0
17/05/2019;21:00;381;168;213;Stellenweiser Regenfall;11;11;0
17/05/2019;22:00;392;130;262;Stellenweiser Regenfall;10;10;0
17/05/2019;23:00;338;65;273;Leicht bewölkt;10;9;0
18/05/2019;00:00;184;52;132;Leicht bewölkt;9;8;0
18/05/2019;01:00;122;32;90;Leicht bewölkt;8;8;0
18/05/2019;02:00;61;19;42;Stellenweiser Regenfall;8;7;0
18/05/2019;03:00;55;20;35;Stellenweiser Regenfall;8;7;0
18/05/2019;04:00;17;8;9;Stellenweiser Regenfall;8;8;0
18/05/2019;05:00;26;16;10;Bewölkt;9;9;0
18/05/2019;06:00;51;33;18;Bewölkt;10;10;0
18/05/2019;07:00;103;58;45;Bewölkt;12;12;0
18/05/2019;08:00;234;134;100;Leicht bewölkt;13;13;0
18/05/2019;09:00;374;248;126;Leicht bewölkt;15;15;0
18/05/2019;10:00;512;317;195;Leicht bewölkt;16;16;0
18/05/2019;11:00;515;294;221;Bewölkt;17;17;0
18/05/2019;12:00;624;324;300;Bewölkt;19;19;0
18/05/2019;13:00;590;283;307;Bewölkt;18;18;0
18/05/2019;14:00;643;286;357;Bewölkt;18;18;0
18/05/2019;15:00;679;292;387;Bewölkt;18;18;0
18/05/2019;16:00;611;290;321;Bewölkt;16;17;0
18/05/2019;17:00;590;299;291;Leichter Regenschauer;15;16;0
18/05/2019;18:00;593;268;325;Leichter Regenschauer;14;15;0
18/05/2019;19:00;497;272;225;Leichter Regenschauer;13;14;0
18/05/2019;20:00;365;159;206;Leichter Regenschauer;13;13;0
18/05/2019;21:00;285;106;179;Leichter Regenschauer;12;12;0
18/05/2019;22:00;285;100;185;Leichter Regenschauer;11;11;0
18/05/2019;23:00;182;64;118;Leicht bewölkt;10;10;0
19/05/2019;00:00;103;33;70;Leicht bewölkt;10;10;0
19/05/2019;01:00;128;63;65;Leicht bewölkt;9;9;0
19/05/2019;02:00;75;32;43;Leicht bewölkt;9;9;0
19/05/2019;03:00;39;21;18;Leicht bewölkt;8;8;0
19/05/2019;04:00;27;22;5;Leicht bewölkt;9;9;0
19/05/2019;05:00;33;18;15;Leicht bewölkt;10;9;0
19/05/2019;06:00;32;17;15;Leicht bewölkt;10;10;0
19/05/2019;07:00;30;15;15;Leicht bewölkt;11;11;0
19/05/2019;08:00;77;40;37;Leicht bewölkt;13;12;0
19/05/2019;09:00;180;107;73;Leicht bewölkt;14;14;0
19/05/2019;10:00;267;135;132;Leicht bewölkt;15;15;0
19/05/2019;11:00;303;158;145;Bewölkt;16;16;0
19/05/2019;12:00;318;155;163;Bewölkt;18;18;0
19/05/2019;13:00;375;160;215;Bewölkt;18;18;0
19/05/2019;14:00;467;248;219;Leichter Regenschauer;18;18;0
19/05/2019;15:00;459;236;223;Leichter Regenschauer;18;18;0
19/05/2019;16:00;490;239;251;Leichter Regenschauer;17;17;0
19/05/2019;17:00;413;203;210;Leichter Regenschauer;16;16;0
19/05/2019;18:00;494;206;288;Leichter Regenschauer;15;15;0
19/05/2019;19:00;211;90;121;Leichter Regenschauer;14;14;0
19/05/2019;20:00;152;70;82;Stellenweiser Regenfall;13;13;0
19/05/2019;21:00;103;48;55;Stellenweiser Regenfall;12;11;0
19/05/2019;22:00;74;25;49;Stellenweiser Regenfall;11;10;0
19/05/2019;23:00;58;20;38;Leichter Regenschauer;10;10;0
20/05/2019;00:00;26;11;15;Leichter Regenschauer;10;9;0
20/05/2019;01:00;10;4;6;Leichter Regenschauer;10;9;0
20/05/2019;02:00;7;4;3;Stellenweise Gewitter und Niederschläge;10;9;0
20/05/2019;03:00;6;3;3;Stellenweise Gewitter und Niederschläge;10;9;0
20/05/2019;04:00;7;7;0;Stellenweise Gewitter und Niederschläge;10;9;0
20/05/2019;05:00;27;17;10;Leichter Regenfall;10;9;0
20/05/2019;06:00;131;81;50;Leichter Regenfall;10;9;0
20/05/2019;07:00;537;332;205;Leichter Regenfall;10;9;0
20/05/2019;08:00;417;237;180;Mäßiger Regenfall;10;9;1
20/05/2019;09:00;418;276;142;Mäßiger Regenfall;11;9;1
20/05/2019;10:00;229;115;114;Mäßiger Regenfall;11;9;0
20/05/2019;11:00;269;132;137;Mäßiger Regenfall;11;8;1
20/05/2019;12:00;318;136;182;Mäßiger Regenfall;11;8;1
20/05/2019;13:00;423;153;270;Mäßiger Regenfall;10;8;1
20/05/2019;14:00;275;141;134;Starker Regenfall;10;8;1
20/05/2019;15:00;423;195;228;Starker Regenfall;10;8;1
20/05/2019;16:00;401;185;216;Starker Regenfall;10;7;1
20/05/2019;17:00;489;205;284;Mäßiger Regenfall;10;7;1
20/05/2019;18:00;360;156;204;Mäßiger Regenfall;10;7;1
20/05/2019;19:00;330;139;191;Mäßiger Regenfall;9;7;1
20/05/2019;20:00;229;97;132;Starker Regenfall;8;7;1
20/05/2019;21:00;144;60;84;Starker Regenfall;7;6;2
20/05/2019;22:00;133;59;74;Starker Regenfall;8;6;1
20/05/2019;23:00;90;29;61;Starker Regenfall;8;7;2
21/05/2019;00:00;26;11;15;Starker Regenfall;9;7;3
21/05/2019;01:00;11;7;4;Starker Regenfall;9;7;2
21/05/2019;02:00;1;0;1;Starker Regenfall;10;7;1
21/05/2019;03:00;9;7;2;Starker Regenfall;10;7;2
21/05/2019;04:00;5;5;0;Starker Regenfall;10;7;1
21/05/2019;05:00;21;14;7;Mäßiger Regenfall;10;7;0
21/05/2019;06:00;115;73;42;Mäßiger Regenfall;10;7;0
21/05/2019;07:00;563;369;194;Mäßiger Regenfall;10;7;0
21/05/2019;08:00;482;279;203;Bedeckt;10;8;0
21/05/2019;09:00;430;249;181;Bedeckt;11;8;0
21/05/2019;10:00;182;98;84;Bedeckt;11;8;0
21/05/2019;11:00;290;158;132;Mäßiger Regenfall;11;9;0
21/05/2019;12:00;324;135;189;Mäßiger Regenfall;11;9;1
21/05/2019;13:00;465;196;269;Mäßiger Regenfall;11;9;0
21/05/2019;14:00;264;123;141;Mäßiger Regenfall;11;9;1
21/05/2019;15:00;510;239;271;Mäßiger Regenfall;11;9;1
21/05/2019;16:00;429;210;219;Mäßiger Regenfall;11;9;0
21/05/2019;17:00;558;246;312;Mäßiger Regenfall;11;9;1
21/05/2019;18:00;416;186;230;Mäßiger Regenfall;11;10;1
21/05/2019;19:00;384;170;214;Mäßiger Regenfall;11;9;0
21/05/2019;20:00;240;109;131;Mäßiger Regenfall;11;9;0
21/05/2019;21:00;160;61;99;Mäßiger Regenfall;11;9;1
21/05/2019;22:00;169;51;118;Mäßiger Regenfall;11;9;0
21/05/2019;23:00;73;32;41;Mäßiger Regenfall;11;9;0
22/05/2019;00:00;34;18;16;Mäßiger Regenfall;11;10;0
22/05/2019;01:00;22;11;11;Mäßiger Regenfall;10;10;0
22/05/2019;02:00;11;4;7;Leichter Regenfall;10;10;0
22/05/2019;03:00;10;7;3;Leichter Regenfall;10;10;0
22/05/2019;04:00;6;4;2;Leichter Regenfall;10;10;0
22/05/2019;05:00;29;20;9;Leichter Regenfall;10;10;0
22/05/2019;06:00;135;78;57;Leichter Regenfall;10;10;0
22/05/2019;07:00;934;580;354;Leichter Regenfall;11;11;0
22/05/2019;08:00;705;431;274;Nieselregen;11;11;0
22/05/2019;09:00;679;427;252;Nieselregen;11;11;0
22/05/2019;10:00;447;229;218;Nieselregen;12;12;0
22/05/2019;11:00;578;264;314;Nieselregen;13;14;0
22/05/2019;12:00;616;269;347;Nieselregen;15;15;0
22/05/2019;13:00;834;397;437;Nieselregen;15;15;0
22/05/2019;14:00;634;336;298;Leicht bewölkt;16;16;0
22/05/2019;15:00;779;390;389;Leicht bewölkt;17;17;0
22/05/2019;16:00;879;424;455;Leicht bewölkt;16;17;0
22/05/2019;17:00;1065;432;633;Stellenweiser Regenfall;16;16;0
22/05/2019;18:00;839;378;461;Stellenweiser Regenfall;15;16;0
22/05/2019;19:00;732;335;397;Stellenweiser Regenfall;14;14;0
22/05/2019;20:00;517;210;307;Leichter Regenschauer;13;13;0
22/05/2019;21:00;376;185;191;Leichter Regenschauer;12;12;0
22/05/2019;22:00;260;88;172;Leichter Regenschauer;11;11;0
22/05/2019;23:00;186;65;121;Stellenweiser Regenfall;10;9;0
23/05/2019;00:00;119;34;85;Stellenweiser Regenfall;9;8;0
23/05/2019;01:00;67;20;47;Stellenweiser Regenfall;8;8;0
23/05/2019;02:00;19;7;12;Stellenweiser Regenfall;8;8;0
23/05/2019;03:00;12;7;5;Stellenweiser Regenfall;7;7;0
23/05/2019;04:00;9;7;2;Stellenweiser Regenfall;8;8;0
23/05/2019;05:00;42;30;12;Leicht bewölkt;9;9;0
23/05/2019;06:00;180;106;74;Leicht bewölkt;10;10;0
23/05/2019;07:00;1048;676;372;Leicht bewölkt;12;12;0
23/05/2019;08:00;843;501;342;Leicht bewölkt;14;14;0
23/05/2019;09:00;776;450;326;Leicht bewölkt;16;16;0
23/05/2019;10:00;465;263;202;Leicht bewölkt;17;17;0
23/05/2019;11:00;752;401;351;Sonnig;18;18;0
23/05/2019;12:00;701;306;395;Sonnig;19;19;0
23/05/2019;13:00;1012;478;534;Sonnig;19;19;0
23/05/2019;14:00;763;382;381;Leicht bewölkt;19;19;0
23/05/2019;15:00;1162;580;582;Leicht bewölkt;19;19;0
23/05/2019;16:00;1042;486;556;Leicht bewölkt;18;18;0
23/05/2019;17:00;1227;550;677;Leicht bewölkt;17;17;0
23/05/2019;18:00;1068;519;549;Leicht bewölkt;17;17;0
23/05/2019;19:00;856;401;455;Leicht bewölkt;15;15;0
23/05/2019;20:00;582;271;311;Leicht bewölkt;14;13;0
23/05/2019;21:00;371;155;216;Leicht bewölkt;12;12;0
23/05/2019;22:00;390;173;217;Leicht bewölkt;11;11;0
23/05/2019;23:00;301;118;183;Leicht bewölkt;10;10;0
24/05/2019;00:00;113;34;79;Leicht bewölkt;10;9;0
24/05/2019;01:00;84;13;71;Leicht bewölkt;9;9;0
24/05/2019;02:00;91;10;81;Leicht bewölkt;9;9;0
24/05/2019;03:00;23;8;15;Leicht bewölkt;9;9;0
24/05/2019;04:00;13;10;3;Leicht bewölkt;10;10;0
24/05/2019;05:00;44;24;20;Leicht bewölkt;11;11;0
24/05/2019;06:00;169;109;60;Leicht bewölkt;12;12;0
24/05/2019;07:00;957;624;333;Leicht bewölkt;14;14;0
24/05/2019;08:00;806;475;331;Leicht bewölkt;16;16;0
24/05/2019;09:00;778;446;332;Leicht bewölkt;18;18;0
24/05/2019;10:00;524;300;224;Leicht bewölkt;19;19;0
24/05/2019;11:00;743;378;365;Leicht bewölkt;20;20;0
24/05/2019;12:00;939;434;505;Leicht bewölkt;21;21;0
24/05/2019;13:00;1108;424;684;Leicht bewölkt;21;21;0
24/05/2019;14:00;784;373;411;Leicht bewölkt;21;21;0
24/05/2019;15:00;851;416;435;Leicht bewölkt;21;21;0
24/05/2019;16:00;827;417;410;Leicht bewölkt;20;20;0
24/05/2019;17:00;927;437;490;Leicht bewölkt;19;19;0
24/05/2019;18:00;802;404;398;Leicht bewölkt;18;18;0
24/05/2019;19:00;689;323;366;Leicht bewölkt;17;17;0
24/05/2019;20:00;500;247;253;Stellenweiser Regenfall;15;15;0
24/05/2019;21:00;443;200;243;Stellenweiser Regenfall;14;14;0
24/05/2019;22:00;333;110;223;Stellenweiser Regenfall;13;13;0
24/05/2019;23:00;299;98;201;Stellenweiser Regenfall;12;12;0
25/05/2019;00:00;217;71;146;Stellenweiser Regenfall;11;11;0
25/05/2019;01:00;117;29;88;Stellenweiser Regenfall;11;11;0
25/05/2019;02:00;64;16;48;Stellenweiser Regenfall;10;10;0
25/05/2019;03:00;59;34;25;Stellenweiser Regenfall;10;10;0
25/05/2019;04:00;14;9;5;Stellenweiser Regenfall;11;11;0
25/05/2019;05:00;27;18;9;Leicht bewölkt;12;12;0
25/05/2019;06:00;48;35;13;Leicht bewölkt;13;13;0
25/05/2019;07:00;111;65;46;Leicht bewölkt;14;14;0
25/05/2019;08:00;191;113;78;Stellenweiser Regenfall;16;16;0
25/05/2019;09:00;392;230;162;Stellenweiser Regenfall;17;17;0
25/05/2019;10:00;413;238;175;Stellenweiser Regenfall;18;18;0
25/05/2019;11:00;529;280;249;Leicht bewölkt;19;19;0
25/05/2019;12:00;594;301;293;Leicht bewölkt;20;20;0
25/05/2019;13:00;577;294;283;Leicht bewölkt;20;20;0
25/05/2019;14:00;771;379;392;Leicht bewölkt;19;19;0
25/05/2019;15:00;510;221;289;Leicht bewölkt;19;19;0
25/05/2019;16:00;455;197;258;Leicht bewölkt;18;18;0
25/05/2019;17:00;373;190;183;Leichter Regenschauer;17;17;0
25/05/2019;18:00;384;192;192;Leichter Regenschauer;16;16;0
25/05/2019;19:00;282;144;138;Leichter Regenschauer;15;15;0
25/05/2019;20:00;235;124;111;Bewölkt;14;14;0
25/05/2019;21:00;182;80;102;Bewölkt;13;13;0
25/05/2019;22:00;184;78;106;Bewölkt;12;12;0
25/05/2019;23:00;187;86;101;Nieselregen;11;11;0
26/05/2019;00:00;156;63;93;Nieselregen;11;11;0
26/05/2019;01:00;114;37;77;Nieselregen;10;10;0
26/05/2019;02:00;63;20;43;Stellenweiser Regenfall;10;10;0
26/05/2019;03:00;45;13;32;Stellenweiser Regenfall;9;9;0
26/05/2019;04:00;26;8;18;Stellenweiser Regenfall;10;10;0
26/05/2019;05:00;28;10;18;Leicht bewölkt;11;11;0
26/05/2019;06:00;41;18;23;Leicht bewölkt;12;12;0
26/05/2019;07:00;48;18;30;Leicht bewölkt;13;13;0
26/05/2019;08:00;89;42;47;Leicht bewölkt;15;15;0
26/05/2019;09:00;264;141;123;Leicht bewölkt;17;17;0
26/05/2019;10:00;326;180;146;Leicht bewölkt;18;18;0
26/05/2019;11:00;470;265;205;Leicht bewölkt;20;20;0
26/05/2019;12:00;589;337;252;Leicht bewölkt;21;21;0
26/05/2019;13:00;586;321;265;Leicht bewölkt;21;21;0
26/05/2019;14:00;723;407;316;Leicht bewölkt;21;21;0
26/05/2019;15:00;790;427;363;Leicht bewölkt;22;22;0
26/05/2019;16:00;753;352;401;Leicht bewölkt;21;21;0
26/05/2019;17:00;724;304;420;Leicht bewölkt;20;20;0
26/05/2019;18:00;571;246;325;Leicht bewölkt;19;19;0
26/05/2019;19:00;432;200;232;Leicht bewölkt;18;18;0
26/05/2019;20:00;391;170;221;Leicht bewölkt;16;16;0
26/05/2019;21:00;259;77;182;Leicht bewölkt;15;15;0
26/05/2019;22:00;183;68;115;Leicht bewölkt;14;14;0
26/05/2019;23:00;92;32;60;Leicht bewölkt;13;13;0
27/05/2019;00:00;41;14;27;Leicht bewölkt;12;12;0
27/05/2019;01:00;10;4;6;Leicht bewölkt;11;11;0
27/05/2019;02:00;10;4;6;Leicht bewölkt;11;11;0
27/05/2019;03:00;6;4;2;Leicht bewölkt;10;10;0
27/05/2019;04:00;4;3;1;Leicht bewölkt;11;11;0
27/05/2019;05:00;51;37;14;Leicht bewölkt;12;12;0
27/05/2019;06:00;163;99;64;Leicht bewölkt;13;13;0
27/05/2019;07:00;1072;692;380;Leicht bewölkt;15;15;0
27/05/2019;08:00;707;396;311;Leicht bewölkt;16;16;0
27/05/2019;09:00;755;476;279;Leicht bewölkt;18;18;0
27/05/2019;10:00;505;279;226;Leicht bewölkt;19;19;0
27/05/2019;11:00;708;322;386;Leicht bewölkt;19;19;0
27/05/2019;12:00;691;326;365;Leicht bewölkt;20;20;0
27/05/2019;13:00;908;365;543;Leicht bewölkt;20;20;0
27/05/2019;14:00;655;300;355;Leicht bewölkt;21;21;0
27/05/2019;15:00;927;423;504;Leicht bewölkt;21;21;0
27/05/2019;16:00;934;469;465;Leicht bewölkt;20;20;0
27/05/2019;17:00;997;458;539;Leichter Regenschauer;19;19;0
27/05/2019;18:00;911;429;482;Leichter Regenschauer;18;18;0
27/05/2019;19:00;666;298;368;Leichter Regenschauer;16;17;0
27/05/2019;20:00;463;210;253;Leichter Regenschauer;15;16;0
27/05/2019;21:00;285;121;164;Leichter Regenschauer;14;15;0
27/05/2019;22:00;255;92;163;Leichter Regenschauer;14;14;0
27/05/2019;23:00;142;48;94;Mäßiger bis starker Regenschauer;13;13;0
28/05/2019;00:00;69;21;48;Mäßiger bis starker Regenschauer;12;12;0
28/05/2019;01:00;31;16;15;Mäßiger bis starker Regenschauer;12;12;0
28/05/2019;02:00;8;3;5;Mäßiger bis starker Regenschauer;12;12;0
28/05/2019;03:00;6;6;0;Mäßiger bis starker Regenschauer;12;12;1
28/05/2019;04:00;7;5;2;Mäßiger bis starker Regenschauer;12;12;0
28/05/2019;05:00;38;25;13;Mäßiger Regenfall;12;12;0
28/05/2019;06:00;151;97;54;Mäßiger Regenfall;13;13;0
28/05/2019;07:00;653;431;222;Mäßiger Regenfall;13;13;0
28/05/2019;08:00;647;394;253;Stellenweiser leichter Regenfall;13;13;0
28/05/2019;09:00;693;430;263;Stellenweiser leichter Regenfall;14;13;0
28/05/2019;10:00;386;220;166;Stellenweiser leichter Regenfall;13;13;0
28/05/2019;11:00;499;254;245;Leichter Regenschauer;13;12;0
28/05/2019;12:00;461;200;261;Leichter Regenschauer;13;11;0
28/05/2019;13:00;710;316;394;Leichter Regenschauer;12;11;0
28/05/2019;14:00;482;243;239;Nieselregen;12;10;0
28/05/2019;15:00;740;338;402;Nieselregen;12;10;0
28/05/2019;16:00;710;323;387;Nieselregen;11;10;0
28/05/2019;17:00;937;426;511;Leichter Regenfall;11;10;0
28/05/2019;18:00;638;272;366;Leichter Regenfall;11;10;0
28/05/2019;19:00;572;263;309;Leichter Regenfall;10;9;0
28/05/2019;20:00;326;151;175;Stellenweiser Nieselregen;10;9;0
28/05/2019;21:00;265;107;158;Stellenweiser Nieselregen;9;8;0
28/05/2019;22:00;234;81;153;Stellenweiser Nieselregen;9;8;0
28/05/2019;23:00;94;30;64;Stellenweiser Nieselregen;8;8;0
29/05/2019;00:00;57;14;43;Stellenweiser Nieselregen;8;7;0
29/05/2019;01:00;39;19;20;Stellenweiser Nieselregen;8;7;0
29/05/2019;02:00;12;6;6;Nieselregen;8;7;0
29/05/2019;03:00;6;3;3;Nieselregen;8;7;0
29/05/2019;04:00;4;4;0;Nieselregen;8;7;0
29/05/2019;05:00;45;30;15;Leichter Regenschauer;8;8;0
29/05/2019;06:00;144;96;48;Leichter Regenschauer;9;8;0
29/05/2019;07:00;1043;664;379;Leichter Regenschauer;9;9;0
29/05/2019;08:00;682;422;260;Leichter Regenschauer;10;10;0
29/05/2019;09:00;729;434;295;Leichter Regenschauer;11;11;0
29/05/2019;10:00;454;227;227;Leichter Regenschauer;12;12;0
29/05/2019;11:00;592;256;336;Leichter Regenschauer;13;13;0
29/05/2019;12:00;645;295;350;Leichter Regenschauer;13;14;0
29/05/2019;13:00;863;408;455;Leichter Regenschauer;14;14;0
29/05/2019;14:00;568;253;315;Stellenweiser Regenfall;14;14;0
29/05/2019;15:00;823;366;457;Stellenweiser Regenfall;14;15;0
29/05/2019;16:00;803;387;416;Stellenweiser Regenfall;14;14;0
29/05/2019;17:00;849;371;478;Stellenweiser Regenfall;14;14;0
29/05/2019;18:00;733;302;431;Stellenweiser Regenfall;14;14;0
29/05/2019;19:00;549;268;281;Stellenweiser Regenfall;12;13;0
29/05/2019;20:00;466;223;243;Leicht bewölkt;11;11;0
29/05/2019;21:00;340;165;175;Leicht bewölkt;10;10;0
29/05/2019;22:00;261;123;138;Leicht bewölkt;9;9;0
29/05/2019;23:00;194;75;119;Stellenweiser Regenfall;9;9;0
30/05/2019;00:00;168;48;120;Stellenweiser Regenfall;8;8;0
30/05/2019;01:00;147;48;99;Stellenweiser Regenfall;7;7;0
30/05/2019;02:00;73;32;41;Leicht bewölkt;7;7;0
30/05/2019;03:00;62;21;41;Leicht bewölkt;7;7;0
30/05/2019;04:00;30;15;15;Leicht bewölkt;7;7;0
30/05/2019;05:00;25;18;7;Leicht bewölkt;8;8;0
30/05/2019;06:00;38;24;14;Leicht bewölkt;9;9;0
30/05/2019;07:00;51;23;28;Leicht bewölkt;11;11;0
30/05/2019;08:00;122;59;63;Leicht bewölkt;14;14;0
30/05/2019;09:00;232;102;130;Leicht bewölkt;16;16;0
30/05/2019;10:00;354;171;183;Leicht bewölkt;17;17;0
30/05/2019;11:00;436;211;225;Leicht bewölkt;18;18;0
30/05/2019;12:00;502;217;285;Leicht bewölkt;20;20;0
30/05/2019;13:00;570;275;295;Leicht bewölkt;20;20;0
30/05/2019;14:00;613;291;322;Leicht bewölkt;20;20;0
30/05/2019;15:00;612;328;284;Leicht bewölkt;20;20;0
30/05/2019;16:00;657;342;315;Leicht bewölkt;19;19;0
30/05/2019;17:00;666;355;311;Leicht bewölkt;18;18;0
30/05/2019;18:00;657;378;279;Leicht bewölkt;17;17;0
30/05/2019;19:00;541;272;269;Leicht bewölkt;16;16;0
30/05/2019;20:00;441;212;229;Leicht bewölkt;15;15;0
30/05/2019;21:00;333;141;192;Leicht bewölkt;14;14;0
30/05/2019;22:00;242;95;147;Leicht bewölkt;13;13;0
30/05/2019;23:00;159;59;100;Leicht bewölkt;11;11;0
31/05/2019;00:00;78;33;45;Leicht bewölkt;10;10;0
31/05/2019;01:00;49;16;33;Leicht bewölkt;10;10;0
31/05/2019;02:00;31;20;11;Leicht bewölkt;10;10;0
31/05/2019;03:00;8;3;5;Leicht bewölkt;10;10;0
31/05/2019;04:00;11;5;6;Leicht bewölkt;11;11;0
31/05/2019;05:00;27;16;11;Leicht bewölkt;12;12;0
31/05/2019;06:00;97;63;34;Leicht bewölkt;13;13;0
31/05/2019;07:00;316;183;133;Leicht bewölkt;15;14;0
31/05/2019;08:00;452;271;181;Leicht bewölkt;16;16;0
31/05/2019;09:00;608;376;232;Leicht bewölkt;18;18;0
31/05/2019;10:00;704;406;298;Leicht bewölkt;19;19;0
31/05/2019;11:00;833;455;378;Leicht bewölkt;20;20;0
31/05/2019;12:00;824;352;472;Leicht bewölkt;21;21;0
31/05/2019;13:00;925;429;496;Leicht bewölkt;21;21;0
31/05/2019;14:00;895;431;464;Leicht bewölkt;21;21;0
31/05/2019;15:00;934;469;465;Leicht bewölkt;21;21;0
31/05/2019;16:00;851;377;474;Leicht bewölkt;21;21;0
31/05/2019;17:00;1024;501;523;Leicht bewölkt;20;20;0
31/05/2019;18:00;874;346;528;Leicht bewölkt;19;19;0
31/05/2019;19:00;693;310;383;Leicht bewölkt;18;18;0
31/05/2019;20:00;509;226;283;Leicht bewölkt;17;17;0
31/05/2019;21:00;318;135;183;Leicht bewölkt;15;15;0
31/05/2019;22:00;250;103;147;Leicht bewölkt;14;14;0
31/05/2019;23:00;232;95;137;Leicht bewölkt;14;14;0
01/06/2019;00:00;328;265;63;Leicht bewölkt;13;13;0
01/06/2019;01:00;138;78;60;Leicht bewölkt;13;13;0
01/06/2019;02:00;46;14;32;Leicht bewölkt;12;12;0
01/06/2019;03:00;19;12;7;Leicht bewölkt;12;12;0
01/06/2019;04:00;19;8;11;Leicht bewölkt;13;13;0
01/06/2019;05:00;14;14;0;Leicht bewölkt;14;14;0
01/06/2019;06:00;48;27;21;Leicht bewölkt;15;15;0
01/06/2019;07:00;83;52;31;Leicht bewölkt;16;16;0
01/06/2019;08:00;225;114;111;Leicht bewölkt;18;18;0
01/06/2019;09:00;503;277;226;Leicht bewölkt;19;19;0
01/06/2019;10:00;661;384;277;Leicht bewölkt;20;20;0
01/06/2019;11:00;738;401;337;Leicht bewölkt;21;21;0
01/06/2019;12:00;764;385;379;Leicht bewölkt;23;24;0
01/06/2019;13:00;803;394;409;Leicht bewölkt;23;24;0
01/06/2019;14:00;838;400;438;Leicht bewölkt;23;25;0
01/06/2019;15:00;840;403;437;Leicht bewölkt;23;25;0
01/06/2019;16:00;794;353;441;Leicht bewölkt;22;24;0
01/06/2019;17:00;850;337;513;Leicht bewölkt;22;22;0
01/06/2019;18:00;723;315;408;Leicht bewölkt;21;21;0
01/06/2019;19:00;677;355;322;Leicht bewölkt;19;19;0
01/06/2019;20:00;431;173;258;Leicht bewölkt;18;18;0
01/06/2019;21:00;316;124;192;Leicht bewölkt;17;17;0
01/06/2019;22:00;320;118;202;Leicht bewölkt;16;16;0
01/06/2019;23:00;266;121;145;Leicht bewölkt;15;15;0
02/06/2019;00:00;309;226;83;Leicht bewölkt;15;15;0
02/06/2019;01:00;154;84;70;Leicht bewölkt;14;14;0
02/06/2019;02:00;74;51;23;Leicht bewölkt;14;14;0
02/06/2019;03:00;50;22;28;Leicht bewölkt;14;14;0
02/06/2019;04:00;33;15;18;Leicht bewölkt;14;14;0
02/06/2019;05:00;27;16;11;Leicht bewölkt;15;15;0
02/06/2019;06:00;40;26;14;Leicht bewölkt;16;16;0
02/06/2019;07:00;56;41;15;Leicht bewölkt;18;18;0
02/06/2019;08:00;104;46;58;Leicht bewölkt;20;20;0
02/06/2019;09:00;266;139;127;Leicht bewölkt;22;22;0
02/06/2019;10:00;424;222;202;Leicht bewölkt;23;24;0
02/06/2019;11:00;483;229;254;Leicht bewölkt;24;25;0
02/06/2019;12:00;523;257;266;Leicht bewölkt;26;27;0
02/06/2019;13:00;549;253;296;Leicht bewölkt;26;27;0
02/06/2019;14:00;630;323;307;Leicht bewölkt;26;27;0
02/06/2019;15:00;659;339;320;Leicht bewölkt;27;27;0
02/06/2019;16:00;589;286;303;Leicht bewölkt;26;27;0
02/06/2019;17:00;649;349;300;Leicht bewölkt;25;26;0
02/06/2019;18:00;609;285;324;Leicht bewölkt;25;26;0
02/06/2019;19:00;468;275;193;Leicht bewölkt;24;26;0
02/06/2019;20:00;369;164;205;Sonnig;23;26;0
02/06/2019;21:00;271;102;169;Sonnig;22;25;0
02/06/2019;22:00;206;69;137;Sonnig;21;21;0
02/06/2019;23:00;117;37;80;Sonnig;19;19;0
03/06/2019;00:00;41;17;24;Sonnig;18;18;0
03/06/2019;01:00;16;6;10;Sonnig;17;17;0
03/06/2019;02:00;5;4;1;Leicht bewölkt;16;16;0
03/06/2019;03:00;6;2;4;Leicht bewölkt;15;15;0
03/06/2019;04:00;8;3;5;Leicht bewölkt;16;16;0
03/06/2019;05:00;53;34;19;Leicht bewölkt;17;17;0
03/06/2019;06:00;198;115;83;Leicht bewölkt;17;17;0
03/06/2019;07:00;938;576;362;Leicht bewölkt;19;19;0
03/06/2019;08:00;921;535;386;Leicht bewölkt;21;21;0
03/06/2019;09:00;865;525;340;Leicht bewölkt;23;23;0
03/06/2019;10:00;494;282;212;Leicht bewölkt;24;25;0
03/06/2019;11:00;729;375;354;Leicht bewölkt;25;26;0
03/06/2019;12:00;672;284;388;Leicht bewölkt;26;27;0
03/06/2019;13:00;1004;401;603;Leicht bewölkt;27;27;0
03/06/2019;14:00;727;391;336;Leicht bewölkt;27;27;0
03/06/2019;15:00;1028;478;550;Leicht bewölkt;27;28;0
03/06/2019;16:00;1080;503;577;Leicht bewölkt;26;27;0
03/06/2019;17:00;1136;503;633;Leicht bewölkt;26;27;0
03/06/2019;18:00;1027;491;536;Leicht bewölkt;25;26;0
03/06/2019;19:00;829;388;441;Leicht bewölkt;24;26;0
03/06/2019;20:00;600;267;333;Stellenweiser Regenfall;23;26;0
03/06/2019;21:00;401;150;251;Stellenweiser Regenfall;22;25;0
03/06/2019;22:00;286;124;162;Stellenweiser Regenfall;20;20;0
03/06/2019;23:00;178;56;122;Leichter Regenschauer;19;19;0
04/06/2019;00:00;67;27;40;Leichter Regenschauer;17;17;0
04/06/2019;01:00;30;14;16;Leichter Regenschauer;16;16;0
04/06/2019;02:00;13;7;6;Leicht bewölkt;15;15;0
04/06/2019;03:00;5;4;1;Leicht bewölkt;14;14;0
04/06/2019;04:00;9;8;1;Leicht bewölkt;15;15;0
04/06/2019;05:00;56;36;20;Leicht bewölkt;15;16;0
04/06/2019;06:00;214;134;80;Leicht bewölkt;16;17;0
04/06/2019;07:00;1062;682;380;Leicht bewölkt;18;18;0
04/06/2019;08:00;923;530;393;Leicht bewölkt;20;20;0
04/06/2019;09:00;1026;613;413;Leicht bewölkt;22;22;0
04/06/2019;10:00;618;339;279;Leicht bewölkt;23;24;0
04/06/2019;11:00;809;392;417;Leicht bewölkt;25;26;0
04/06/2019;12:00;782;307;475;Leicht bewölkt;27;27;0
04/06/2019;13:00;1014;445;569;Leicht bewölkt;27;28;0
04/06/2019;14:00;758;358;400;Leicht bewölkt;28;28;0
04/06/2019;15:00;1066;496;570;Leicht bewölkt;28;29;0
04/06/2019;16:00;1053;507;546;Leicht bewölkt;27;28;0
04/06/2019;17:00;1301;641;660;Sonnig;26;27;0
04/06/2019;18:00;1103;477;626;Sonnig;25;27;0
04/06/2019;19:00;873;401;472;Sonnig;24;25;0
04/06/2019;20:00;661;320;341;Sonnig;23;24;0
04/06/2019;21:00;520;227;293;Sonnig;22;22;0
04/06/2019;22:00;422;160;262;Sonnig;20;20;0
04/06/2019;23:00;233;77;156;Leicht bewölkt;19;19;0
05/06/2019;00:00;100;31;69;Leicht bewölkt;18;18;0
05/06/2019;01:00;29;13;16;Leicht bewölkt;17;17;0
05/06/2019;02:00;19;6;13;Leicht bewölkt;16;16;0
05/06/2019;03:00;11;2;9;Leicht bewölkt;16;16;0
05/06/2019;04:00;4;3;1;Leicht bewölkt;17;17;0
05/06/2019;05:00;67;41;26;Leicht bewölkt;17;17;0
05/06/2019;06:00;179;100;79;Leicht bewölkt;18;18;0
05/06/2019;07:00;1097;692;405;Leicht bewölkt;20;20;0
05/06/2019;08:00;939;561;378;Leicht bewölkt;21;21;0
05/06/2019;09:00;855;527;328;Leicht bewölkt;23;24;0
05/06/2019;10:00;601;302;299;Leicht bewölkt;24;25;0
05/06/2019;11:00;814;384;430;Leicht bewölkt;25;26;0
05/06/2019;12:00;812;363;449;Leicht bewölkt;26;27;0
05/06/2019;13:00;1063;489;574;Leicht bewölkt;26;27;0
05/06/2019;14:00;810;342;468;Leicht bewölkt;26;27;0
05/06/2019;15:00;994;458;536;Leicht bewölkt;27;27;0
05/06/2019;16:00;979;474;505;Leicht bewölkt;26;27;0
05/06/2019;17:00;1305;601;704;Nieselregen mit Gewitter;25;26;0
05/06/2019;18:00;1130;521;609;Nieselregen mit Gewitter;24;26;0
05/06/2019;19:00;877;424;453;Nieselregen mit Gewitter;22;24;0
05/06/2019;20:00;704;326;378;Stellenweiser Regenfall;21;21;0
05/06/2019;21:00;510;247;263;Stellenweiser Regenfall;19;19;0
05/06/2019;22:00;394;165;229;Stellenweiser Regenfall;19;19;0
05/06/2019;23:00;257;90;167;Leicht bewölkt;18;18;0
06/06/2019;00:00;144;58;86;Leicht bewölkt;17;17;0
06/06/2019;01:00;85;26;59;Leicht bewölkt;17;17;0
06/06/2019;02:00;7;3;4;Leicht bewölkt;16;16;0
06/06/2019;03:00;29;12;17;Leicht bewölkt;16;16;0
06/06/2019;04:00;9;7;2;Leicht bewölkt;15;15;0
06/06/2019;05:00;42;30;12;Bewölkt;14;14;0
06/06/2019;06:00;193;113;80;Bewölkt;14;13;0
06/06/2019;07:00;927;604;323;Bewölkt;14;13;0
06/06/2019;08:00;851;495;356;Bewölkt;14;13;0
06/06/2019;09:00;818;482;336;Bewölkt;14;13;0
06/06/2019;10:00;507;308;199;Bewölkt;15;14;0
06/06/2019;11:00;699;383;316;Bewölkt;15;15;0
06/06/2019;12:00;672;284;388;Bewölkt;16;16;0
06/06/2019;13:00;852;335;517;Bewölkt;16;16;0
06/06/2019;14:00;676;295;381;Bedeckt;16;16;0
06/06/2019;15:00;876;403;473;Bedeckt;16;16;0
06/06/2019;16:00;929;441;488;Bedeckt;15;15;0
06/06/2019;17:00;955;421;534;Stellenweiser Regenfall;15;15;0
06/06/2019;18:00;854;386;468;Stellenweiser Regenfall;14;14;0
06/06/2019;19:00;668;323;345;Stellenweiser Regenfall;13;13;0
06/06/2019;20:00;487;243;244;Leicht bewölkt;13;12;0
06/06/2019;21:00;316;121;195;Leicht bewölkt;12;12;0
06/06/2019;22:00;263;123;140;Leicht bewölkt;12;11;0
06/06/2019;23:00;183;69;114;Leicht bewölkt;11;11;0
07/06/2019;00:00;110;28;82;Leicht bewölkt;11;10;0
07/06/2019;01:00;54;28;26;Leicht bewölkt;10;10;0
07/06/2019;02:00;16;4;12;Leicht bewölkt;10;9;0
07/06/2019;03:00;5;4;1;Leicht bewölkt;9;9;0
07/06/2019;04:00;13;9;4;Leicht bewölkt;10;10;0
07/06/2019;05:00;53;36;17;Leicht bewölkt;11;11;0
07/06/2019;06:00;154;97;57;Leicht bewölkt;12;12;0
07/06/2019;07:00;848;548;300;Leicht bewölkt;14;14;0
07/06/2019;08:00;871;535;336;Leicht bewölkt;16;16;0
07/06/2019;09:00;737;438;299;Leicht bewölkt;18;19;0
07/06/2019;10:00;643;355;288;Leicht bewölkt;20;20;0
07/06/2019;11:00;830;398;432;Leicht bewölkt;22;22;0
07/06/2019;12:00;981;459;522;Leicht bewölkt;24;24;0
07/06/2019;13:00;968;362;606;Leicht bewölkt;25;25;0
07/06/2019;14:00;813;386;427;Leicht bewölkt;26;26;0
07/06/2019;15:00;862;441;421;Leicht bewölkt;27;27;0
07/06/2019;16:00;861;458;403;Leicht bewölkt;26;28;0
07/06/2019;17:00;893;415;478;Leicht bewölkt;26;28;0
07/06/2019;18:00;940;514;426;Leicht bewölkt;25;28;0
07/06/2019;19:00;851;531;320;Leicht bewölkt;24;27;0
07/06/2019;20:00;655;346;309;Leicht bewölkt;22;25;0
07/06/2019;21:00;529;204;325;Leicht bewölkt;21;21;0
07/06/2019;22:00;452;121;331;Leicht bewölkt;19;18;0
07/06/2019;23:00;300;72;228;Bewölkt;16;16;0
08/06/2019;00:00;235;45;190;Bewölkt;14;13;0
08/06/2019;01:00;140;37;103;Bewölkt;13;12;0
08/06/2019;02:00;95;27;68;Bewölkt;12;11;0
08/06/2019;03:00;55;11;44;Bewölkt;11;10;0
08/06/2019;04:00;23;7;16;Bewölkt;11;10;0
08/06/2019;05:00;27;21;6;Stellenweiser Nieselregen;12;10;0
08/06/2019;06:00;39;20;19;Stellenweiser Nieselregen;12;10;0
08/06/2019;07:00;85;55;30;Stellenweiser Nieselregen;12;11;0
08/06/2019;08:00;255;138;117;Stellenweiser Regenfall;13;12;0
08/06/2019;09:00;352;195;157;Stellenweiser Regenfall;13;13;0
08/06/2019;10:00;564;320;244;Stellenweiser Regenfall;15;14;0
08/06/2019;11:00;662;382;280;Leicht bewölkt;16;16;0
08/06/2019;12:00;600;281;319;Leicht bewölkt;17;17;0
08/06/2019;13:00;686;355;331;Leicht bewölkt;18;18;0
08/06/2019;14:00;721;344;377;Leicht bewölkt;19;19;0
08/06/2019;15:00;624;293;331;Leicht bewölkt;21;21;0
08/06/2019;16:00;690;365;325;Leicht bewölkt;20;20;0
08/06/2019;17:00;635;320;315;Leicht bewölkt;20;20;0
08/06/2019;18:00;622;284;338;Leicht bewölkt;19;19;0
08/06/2019;19:00;500;251;249;Leicht bewölkt;18;18;0
08/06/2019;20:00;434;204;230;Leicht bewölkt;18;18;0
08/06/2019;21:00;354;159;195;Leicht bewölkt;17;17;0
08/06/2019;22:00;263;103;160;Leicht bewölkt;15;15;0
08/06/2019;23:00;185;60;125;Leicht bewölkt;14;14;0
09/06/2019;00:00;202;59;143;Leicht bewölkt;13;13;0
09/06/2019;01:00;122;36;86;Leicht bewölkt;12;12;0
09/06/2019;02:00;58;25;33;Leicht bewölkt;11;11;0
09/06/2019;03:00;40;11;29;Leicht bewölkt;10;10;0
09/06/2019;04:00;16;4;12;Leicht bewölkt;11;11;0
09/06/2019;05:00;16;13;3;Leicht bewölkt;12;12;0
09/06/2019;06:00;41;22;19;Leicht bewölkt;13;13;0
09/06/2019;07:00;44;24;20;Leicht bewölkt;15;15;0
09/06/2019;08:00;100;38;62;Leicht bewölkt;17;17;0
09/06/2019;09:00;257;139;118;Leicht bewölkt;19;19;0
09/06/2019;10:00;368;182;186;Leicht bewölkt;20;20;0
09/06/2019;11:00;417;226;191;Leicht bewölkt;21;22;0
09/06/2019;12:00;391;196;195;Leicht bewölkt;23;25;0
09/06/2019;13:00;378;190;188;Leicht bewölkt;22;22;0
09/06/2019;14:00;407;205;202;Bewölkt;21;21;0
09/06/2019;15:00;374;204;170;Bewölkt;20;20;0
09/06/2019;16:00;421;230;191;Bewölkt;18;18;0
09/06/2019;17:00;309;152;157;Nieselregen;17;17;0
09/06/2019;18:00;267;126;141;Nieselregen;15;15;0
09/06/2019;19:00;246;129;117;Nieselregen;15;15;0
09/06/2019;20:00;207;82;125;Leichter Regenfall;14;14;0
09/06/2019;21:00;162;60;102;Leichter Regenfall;14;14;0
09/06/2019;22:00;151;69;82;Leichter Regenfall;13;13;0
09/06/2019;23:00;110;51;59;Leichter Regenfall;13;13;0
10/06/2019;00:00;60;20;40;Leichter Regenfall;13;13;0
10/06/2019;01:00;42;13;29;Leichter Regenfall;13;13;0
10/06/2019;02:00;20;7;13;Stellenweiser leichter Regenfall;12;12;0
10/06/2019;03:00;12;7;5;Stellenweiser leichter Regenfall;12;12;0
10/06/2019;04:00;3;2;1;Stellenweiser leichter Regenfall;13;13;0
10/06/2019;05:00;12;8;4;Leichter Nebel;13;13;0
10/06/2019;06:00;41;26;15;Leichter Nebel;14;14;0
10/06/2019;07:00;44;34;10;Leichter Nebel;15;15;0
10/06/2019;08:00;73;34;39;Bedeckt;16;16;0
10/06/2019;09:00;101;60;41;Bedeckt;17;17;0
10/06/2019;10:00;162;79;83;Bedeckt;18;18;0
10/06/2019;11:00;219;89;130;Bewölkt;19;19;0
10/06/2019;12:00;190;98;92;Bewölkt;20;20;0
10/06/2019;13:00;142;71;71;Bewölkt;21;21;0
10/06/2019;14:00;146;64;82;Leicht bewölkt;21;21;0
10/06/2019;15:00;103;49;54;Leicht bewölkt;21;21;0
10/06/2019;16:00;185;117;68;Leicht bewölkt;20;20;0
10/06/2019;17:00;201;99;102;Stellenweise Gewitter und Niederschläge;19;19;0
10/06/2019;18:00;251;118;133;Stellenweise Gewitter und Niederschläge;19;19;0
10/06/2019;19:00;159;87;72;Stellenweise Gewitter und Niederschläge;18;17;0
10/06/2019;20:00;163;74;89;Leichter Regenschauer;17;16;0
10/06/2019;21:00;119;67;52;Leichter Regenschauer;15;15;0
10/06/2019;22:00;88;32;56;Leichter Regenschauer;15;14;0
10/06/2019;23:00;61;22;39;Leichter Regenschauer;14;14;0
11/06/2019;00:00;46;19;27;Leichter Regenschauer;14;13;0
11/06/2019;01:00;12;4;8;Leichter Regenschauer;13;13;0
11/06/2019;02:00;10;6;4;Leichter Nebel;13;12;0
11/06/2019;03:00;2;2;0;Leichter Nebel;12;12;0
11/06/2019;04:00;1;1;0;Leichter Nebel;12;12;0
11/06/2019;05:00;36;22;14;Teilweise mäßiger Regenfall;13;12;0
11/06/2019;06:00;147;86;61;Teilweise mäßiger Regenfall;13;12;1
11/06/2019;07:00;375;194;181;Teilweise mäßiger Regenfall;13;13;0
11/06/2019;08:00;599;329;270;Mäßiger Regenfall;13;13;0
11/06/2019;09:00;534;289;245;Mäßiger Regenfall;14;13;0
11/06/2019;10:00;450;262;188;Mäßiger Regenfall;15;14;0
11/06/2019;11:00;499;250;249;Stellenweiser Regenfall;16;15;0
11/06/2019;12:00;510;229;281;Stellenweiser Regenfall;16;16;0
11/06/2019;13:00;522;216;306;Stellenweiser Regenfall;17;17;0
11/06/2019;14:00;531;272;259;Stellenweiser Regenfall;18;18;0
11/06/2019;15:00;522;283;239;Stellenweiser Regenfall;19;19;0
11/06/2019;16:00;706;340;366;Stellenweiser Regenfall;18;18;0
11/06/2019;17:00;725;369;356;Stellenweiser Regenfall;18;18;0
11/06/2019;18:00;664;297;367;Stellenweiser Regenfall;18;18;0
11/06/2019;19:00;494;210;284;Stellenweiser Regenfall;17;17;0
11/06/2019;20:00;330;159;171;Bewölkt;17;17;0
11/06/2019;21:00;241;118;123;Bewölkt;16;16;0
11/06/2019;22:00;203;71;132;Bewölkt;15;15;0
11/06/2019;23:00;92;41;51;Nebel;15;15;0
12/06/2019;00:00;64;20;44;Nebel;15;15;0
12/06/2019;01:00;17;3;14;Nebel;15;15;0
12/06/2019;02:00;12;1;11;Leichter Nebel;14;14;0
12/06/2019;03:00;5;3;2;Leichter Nebel;14;14;0
12/06/2019;04:00;4;2;2;Leichter Nebel;14;14;0
12/06/2019;05:00;22;14;8;Nieselregen;14;14;0
12/06/2019;06:00;97;53;44;Nieselregen;14;14;0
12/06/2019;07:00;190;98;92;Nieselregen;13;13;0
12/06/2019;08:00;324;146;178;Nieselregen;13;12;0
12/06/2019;09:00;267;125;142;Nieselregen;13;11;0
12/06/2019;10:00;234;138;96;Nieselregen;13;12;0
12/06/2019;11:00;276;132;144;Leichter Regenfall;13;12;0
12/06/2019;12:00;357;176;181;Leichter Regenfall;14;13;0
12/06/2019;13:00;441;226;215;Leichter Regenfall;15;14;0
12/06/2019;14:00;489;243;246;Stellenweiser Regenfall;16;16;0
12/06/2019;15:00;477;243;234;Stellenweiser Regenfall;18;18;0
12/06/2019;16:00;619;322;297;Stellenweiser Regenfall;18;18;0
12/06/2019;17:00;720;363;357;Leicht bewölkt;18;18;0
12/06/2019;18:00;672;328;344;Leicht bewölkt;18;18;0
12/06/2019;19:00;523;256;267;Leicht bewölkt;17;17;0
12/06/2019;20:00;452;189;263;Leicht bewölkt;16;16;0
12/06/2019;21:00;314;146;168;Leicht bewölkt;15;15;0
12/06/2019;22:00;312;151;161;Leicht bewölkt;14;14;0
12/06/2019;23:00;156;67;89;Leicht bewölkt;14;14;0
13/06/2019;00:00;100;37;63;Leicht bewölkt;13;13;0
13/06/2019;01:00;48;16;32;Leicht bewölkt;13;13;0
13/06/2019;02:00;34;16;18;Leicht bewölkt;13;13;0
13/06/2019;03:00;27;17;10;Leicht bewölkt;13;13;0
13/06/2019;04:00;13;10;3;Leicht bewölkt;13;14;0
13/06/2019;05:00;52;32;20;Leicht bewölkt;14;14;0
13/06/2019;06:00;153;95;58;Leicht bewölkt;14;15;0
13/06/2019;07:00;400;199;201;Leicht bewölkt;16;16;0
13/06/2019;08:00;577;305;272;Leicht bewölkt;17;17;0
13/06/2019;09:00;597;308;289;Leicht bewölkt;19;19;0
13/06/2019;10:00;477;270;207;Leicht bewölkt;20;20;0
13/06/2019;11:00;538;275;263;Leicht bewölkt;22;22;0
13/06/2019;12:00;585;285;300;Leicht bewölkt;23;24;0
13/06/2019;13:00;597;285;312;Leicht bewölkt;23;24;0
13/06/2019;14:00;665;359;306;Leicht bewölkt;24;25;0
13/06/2019;15:00;695;372;323;Leicht bewölkt;24;26;0
13/06/2019;16:00;888;453;435;Leicht bewölkt;23;24;0
13/06/2019;17:00;903;457;446;Leicht bewölkt;23;23;0
13/06/2019;18:00;890;431;459;Leicht bewölkt;22;22;0
13/06/2019;19:00;674;341;333;Leicht bewölkt;21;21;0
13/06/2019;20:00;535;237;298;Leicht bewölkt;19;19;0
13/06/2019;21:00;408;201;207;Leicht bewölkt;18;18;0
13/06/2019;22:00;349;134;215;Leicht bewölkt;17;17;0
13/06/2019;23:00;180;73;107;Leicht bewölkt;16;16;0
14/06/2019;00:00;119;36;83;Leicht bewölkt;15;15;0
14/06/2019;01:00;55;20;35;Leicht bewölkt;14;15;0
14/06/2019;02:00;24;5;19;Leicht bewölkt;13;14;0
14/06/2019;03:00;7;5;2;Leicht bewölkt;13;13;0
14/06/2019;04:00;8;5;3;Leicht bewölkt;14;14;0
14/06/2019;05:00;44;29;15;Leicht bewölkt;15;15;0
14/06/2019;06:00;153;93;60;Leicht bewölkt;16;16;0
14/06/2019;07:00;361;183;178;Leicht bewölkt;17;18;0
14/06/2019;08:00;568;316;252;Leicht bewölkt;19;19;0
14/06/2019;09:00;589;344;245;Leicht bewölkt;21;21;0
14/06/2019;10:00;599;346;253;Leicht bewölkt;23;24;0
14/06/2019;11:00;596;279;317;Leicht bewölkt;24;25;0
14/06/2019;12:00;623;310;313;Leicht bewölkt;25;26;0
14/06/2019;13:00;660;277;383;Leicht bewölkt;25;26;0
14/06/2019;14:00;705;369;336;Leicht bewölkt;26;26;0
14/06/2019;15:00;678;352;326;Leicht bewölkt;26;27;0
14/06/2019;16:00;653;328;325;Leicht bewölkt;25;26;0
14/06/2019;17:00;738;369;369;Leicht bewölkt;24;26;0
14/06/2019;18:00;734;334;400;Leicht bewölkt;23;25;0
14/06/2019;19:00;574;317;257;Leicht bewölkt;22;24;0
14/06/2019;20:00;421;223;198;Leicht bewölkt;21;21;0
14/06/2019;21:00;347;162;185;Leicht bewölkt;20;20;0
14/06/2019;22:00;300;101;199;Leicht bewölkt;19;19;0
14/06/2019;23:00;224;68;156;Stellenweiser Regenfall;18;18;0
15/06/2019;00:00;176;40;136;Stellenweiser Regenfall;17;17;0
15/06/2019;01:00;86;33;53;Stellenweiser Regenfall;16;16;0
15/06/2019;02:00;58;14;44;Stellenweiser Regenfall;16;15;0
15/06/2019;03:00;35;19;16;Stellenweiser Regenfall;15;14;0
15/06/2019;04:00;13;6;7;Stellenweiser Regenfall;15;15;0
15/06/2019;05:00;28;12;16;Stellenweiser Regenfall;16;15;0
15/06/2019;06:00;47;30;17;Stellenweiser Regenfall;16;16;0
15/06/2019;07:00;83;44;39;Stellenweiser Regenfall;17;17;0
15/06/2019;08:00;202;101;101;Stellenweiser Regenfall;19;18;0
15/06/2019;09:00;377;223;154;Stellenweiser Regenfall;20;20;0
15/06/2019;10:00;503;280;223;Stellenweiser Regenfall;20;20;0
15/06/2019;11:00;564;306;258;Leicht bewölkt;21;21;0
15/06/2019;12:00;529;273;256;Leicht bewölkt;21;21;0
15/06/2019;13:00;510;279;231;Leicht bewölkt;21;21;0
15/06/2019;14:00;632;302;330;Leicht bewölkt;21;21;0
15/06/2019;15:00;599;312;287;Leicht bewölkt;21;21;0
15/06/2019;16:00;615;316;299;Leicht bewölkt;21;21;0
15/06/2019;17:00;576;282;294;Stellenweise Gewitter und Niederschläge;20;20;0
15/06/2019;18:00;543;237;306;Stellenweise Gewitter und Niederschläge;20;20;0
15/06/2019;19:00;448;193;255;Stellenweise Gewitter und Niederschläge;19;19;0
15/06/2019;20:00;335;133;202;Leichter Regenschauer;18;17;0
15/06/2019;21:00;124;34;90;Leichter Regenschauer;16;16;0
15/06/2019;22:00;119;46;73;Leichter Regenschauer;16;15;0
15/06/2019;23:00;122;41;81;Mäßiger bis starker Regenschauer;15;14;1
16/06/2019;00:00;88;27;61;Mäßiger bis starker Regenschauer;14;13;2
16/06/2019;01:00;74;13;61;Mäßiger bis starker Regenschauer;13;13;1
16/06/2019;02:00;33;11;22;Sintflutartiger Regenfall;13;12;0
16/06/2019;03:00;36;9;27;Sintflutartiger Regenfall;12;12;1
16/06/2019;04:00;20;13;7;Sintflutartiger Regenfall;12;12;0
16/06/2019;05:00;19;9;10;Bewölkt;13;12;0
16/06/2019;06:00;33;19;14;Bewölkt;13;13;0
16/06/2019;07:00;41;24;17;Bewölkt;14;13;0
16/06/2019;08:00;67;34;33;Bewölkt;14;13;0
16/06/2019;09:00;124;61;63;Bewölkt;14;14;0
16/06/2019;10:00;167;86;81;Bewölkt;15;15;0
16/06/2019;11:00;241;114;127;Nieselregen;16;16;0
16/06/2019;12:00;294;160;134;Nieselregen;17;17;0
16/06/2019;13:00;326;164;162;Nieselregen;18;18;0
16/06/2019;14:00;443;206;237;Leicht bewölkt;19;19;0
16/06/2019;15:00;474;251;223;Leicht bewölkt;19;19;0
16/06/2019;16:00;426;222;204;Leicht bewölkt;19;19;0
16/06/2019;17:00;482;247;235;Stellenweiser Regenfall;19;19;0
16/06/2019;18:00;541;265;276;Stellenweiser Regenfall;19;19;0
16/06/2019;19:00;368;181;187;Stellenweiser Regenfall;18;18;0
16/06/2019;20:00;363;175;188;Leicht bewölkt;18;18;0
16/06/2019;21:00;306;144;162;Leicht bewölkt;17;17;0
16/06/2019;22:00;190;78;112;Leicht bewölkt;15;15;0
16/06/2019;23:00;105;39;66;Leicht bewölkt;14;14;0
17/06/2019;00:00;39;21;18;Leicht bewölkt;13;13;0
17/06/2019;01:00;33;15;18;Leicht bewölkt;12;12;0
17/06/2019;02:00;1;0;1;Leichter Nebel;11;11;0
17/06/2019;03:00;9;5;4;Leichter Nebel;11;10;0
17/06/2019;04:00;10;5;5;Leichter Nebel;12;11;0
17/06/2019;05:00;50;34;16;Leichter Nebel;13;12;0
17/06/2019;06:00;168;112;56;Leichter Nebel;14;13;0
17/06/2019;07:00;491;286;205;Leichter Nebel;15;15;0
17/06/2019;08:00;611;331;280;Leicht bewölkt;17;17;0
17/06/2019;09:00;751;463;288;Leicht bewölkt;19;19;0
17/06/2019;10:00;531;308;223;Leicht bewölkt;20;20;0
17/06/2019;11:00;703;369;334;Leicht bewölkt;21;21;0
17/06/2019;12:00;602;295;307;Leicht bewölkt;22;23;0
17/06/2019;13:00;686;303;383;Leicht bewölkt;23;24;0
17/06/2019;14:00;738;397;341;Leicht bewölkt;23;25;0
17/06/2019;15:00;812;382;430;Leicht bewölkt;24;25;0
17/06/2019;16:00;926;444;482;Leicht bewölkt;23;24;0
17/06/2019;17:00;1055;474;581;Leicht bewölkt;22;23;0
17/06/2019;18:00;918;445;473;Leicht bewölkt;22;22;0
17/06/2019;19:00;850;374;476;Leicht bewölkt;20;20;0
17/06/2019;20:00;578;257;321;Leicht bewölkt;19;19;0
17/06/2019;21:00;499;198;301;Leicht bewölkt;18;18;0
17/06/2019;22:00;311;143;168;Leicht bewölkt;17;17;0
17/06/2019;23:00;182;56;126;Leicht bewölkt;16;16;0
18/06/2019;00:00;111;36;75;Leicht bewölkt;15;15;0
18/06/2019;01:00;24;5;19;Leicht bewölkt;14;14;0
18/06/2019;02:00;14;5;9;Leichter Nebel;13;13;0
18/06/2019;03:00;6;1;5;Leichter Nebel;13;13;0
18/06/2019;04:00;8;4;4;Leichter Nebel;14;14;0
18/06/2019;05:00;53;33;20;Leicht bewölkt;15;15;0
18/06/2019;06:00;179;121;58;Leicht bewölkt;16;16;0
18/06/2019;07:00;603;371;232;Leicht bewölkt;18;18;0
18/06/2019;08:00;738;433;305;Leicht bewölkt;20;20;0
18/06/2019;09:00;800;499;301;Leicht bewölkt;23;24;0
18/06/2019;10:00;614;332;282;Leicht bewölkt;24;25;0
18/06/2019;11:00;724;397;327;Leicht bewölkt;26;27;0
18/06/2019;12:00;683;307;376;Leicht bewölkt;27;28;0
18/06/2019;13:00;730;364;366;Leicht bewölkt;27;28;0
18/06/2019;14:00;715;327;388;Leicht bewölkt;28;28;0
18/06/2019;15:00;879;403;476;Leicht bewölkt;28;28;0
18/06/2019;16:00;926;421;505;Leicht bewölkt;27;28;0
18/06/2019;17:00;1141;530;611;Leicht bewölkt;27;28;0
18/06/2019;18:00;1017;464;553;Leicht bewölkt;26;28;0
18/06/2019;19:00;863;405;458;Leicht bewölkt;25;27;0
18/06/2019;20:00;651;295;356;Stellenweise Gewitter und Niederschläge;24;26;0
18/06/2019;21:00;364;163;201;Stellenweise Gewitter und Niederschläge;23;25;0
18/06/2019;22:00;318;132;186;Stellenweise Gewitter und Niederschläge;21;21;0
18/06/2019;23:00;156;70;86;Leichter Regenschauer;20;20;0
19/06/2019;00:00;68;21;47;Leichter Regenschauer;18;18;0
19/06/2019;01:00;40;10;30;Leichter Regenschauer;17;17;0
19/06/2019;02:00;15;7;8;Leicht bewölkt;16;17;0
19/06/2019;03:00;9;4;5;Leicht bewölkt;15;16;0
19/06/2019;04:00;10;6;4;Leicht bewölkt;16;16;0
19/06/2019;05:00;52;35;17;Leicht bewölkt;17;17;0
19/06/2019;06:00;172;111;61;Leicht bewölkt;18;18;0
19/06/2019;07:00;606;404;202;Leicht bewölkt;20;20;0
19/06/2019;08:00;743;431;312;Leicht bewölkt;22;22;0
19/06/2019;09:00;792;474;318;Leicht bewölkt;24;25;0
19/06/2019;10:00;664;369;295;Leicht bewölkt;25;26;0
19/06/2019;11:00;723;351;372;Leicht bewölkt;27;27;0
19/06/2019;12:00;681;303;378;Leicht bewölkt;28;29;0
19/06/2019;13:00;746;365;381;Leicht bewölkt;29;29;0
19/06/2019;14:00;729;303;426;Leicht bewölkt;29;29;0
19/06/2019;15:00;872;355;517;Leicht bewölkt;29;29;0
19/06/2019;16:00;924;415;509;Leicht bewölkt;29;30;0
19/06/2019;17:00;1149;538;611;Leicht bewölkt;28;30;0
19/06/2019;18:00;1001;496;505;Leicht bewölkt;28;30;0
19/06/2019;19:00;835;427;408;Leicht bewölkt;27;30;0
19/06/2019;20:00;687;375;312;Leicht bewölkt;26;29;0
19/06/2019;21:00;590;290;300;Leicht bewölkt;25;29;0
19/06/2019;22:00;537;176;361;Leicht bewölkt;22;25;0
19/06/2019;23:00;222;57;165;Stellenweise Gewitter und Niederschläge;20;20;0
20/06/2019;00:00;198;59;139;Stellenweise Gewitter und Niederschläge;18;18;0
20/06/2019;01:00;102;38;64;Stellenweise Gewitter und Niederschläge;17;17;0
20/06/2019;02:00;62;26;36;Leicht bewölkt;16;17;0
20/06/2019;03:00;31;14;17;Leicht bewölkt;15;16;0
20/06/2019;04:00;20;11;9;Leicht bewölkt;15;16;0
20/06/2019;05:00;25;17;8;Nieselregen mit Gewitter;16;17;0
20/06/2019;06:00;66;52;14;Nieselregen mit Gewitter;17;17;0
20/06/2019;07:00;98;64;34;Nieselregen mit Gewitter;17;17;0
20/06/2019;08:00;174;98;76;Stellenweise Gewitter und Niederschläge;18;18;0
20/06/2019;09:00;293;162;131;Stellenweise Gewitter und Niederschläge;18;18;0
20/06/2019;10:00;345;193;152;Stellenweise Gewitter und Niederschläge;19;19;0
20/06/2019;11:00;334;159;175;Leichter Regenschauer;19;19;0
20/06/2019;12:00;336;160;176;Leichter Regenschauer;19;19;0
20/06/2019;13:00;294;143;151;Leichter Regenschauer;20;20;0
20/06/2019;14:00;296;183;113;Bedeckt;21;21;0
20/06/2019;15:00;317;172;145;Bedeckt;22;22;0
20/06/2019;16:00;421;220;201;Bedeckt;21;21;0
20/06/2019;17:00;449;231;218;Stellenweiser Regenfall;21;21;0
20/06/2019;18:00;456;215;241;Stellenweiser Regenfall;21;21;0
20/06/2019;19:00;314;136;178;Stellenweiser Regenfall;20;20;0
20/06/2019;20:00;251;118;133;Leicht bewölkt;19;19;0
20/06/2019;21:00;247;108;139;Leicht bewölkt;18;18;0
20/06/2019;22:00;183;78;105;Leicht bewölkt;17;17;0
20/06/2019;23:00;123;51;72;Leichter Regenschauer;16;16;0
21/06/2019;00:00;91;37;54;Leichter Regenschauer;15;15;0
21/06/2019;01:00;48;11;37;Leichter Regenschauer;14;14;0
21/06/2019;02:00;30;13;17;Leicht bewölkt;13;13;0
21/06/2019;03:00;10;2;8;Leicht bewölkt;13;13;0
21/06/2019;04:00;8;6;2;Leicht bewölkt;14;14;0
21/06/2019;05:00;33;21;12;Leicht bewölkt;14;14;0
21/06/2019;06:00;127;93;34;Leicht bewölkt;15;15;0
21/06/2019;07:00;317;195;122;Leicht bewölkt;17;17;0
21/06/2019;08:00;545;349;196;Leicht bewölkt;18;18;0
21/06/2019;09:00;690;410;280;Leicht bewölkt;20;20;0
21/06/2019;10:00;661;385;276;Leicht bewölkt;21;21;0
21/06/2019;11:00;724;404;320;Leicht bewölkt;22;22;0
21/06/2019;12:00;747;333;414;Leicht bewölkt;23;25;0
21/06/2019;13:00;706;335;371;Leicht bewölkt;22;24;0
21/06/2019;14:00;639;311;328;Leicht bewölkt;22;23;0
21/06/2019;15:00;650;323;327;Leicht bewölkt;22;22;0
21/06/2019;16:00;660;312;348;Leicht bewölkt;21;21;0
21/06/2019;17:00;772;344;428;Leichter Regenschauer;20;20;1
21/06/2019;18:00;651;271;380;Leichter Regenschauer;19;19;1
21/06/2019;19:00;550;240;310;Leichter Regenschauer;18;18;0
21/06/2019;20:00;457;209;248;Mäßiger bis starker Regenschauer;17;17;0
21/06/2019;21:00;349;169;180;Mäßiger bis starker Regenschauer;16;16;0
21/06/2019;22:00;259;101;158;Mäßiger bis starker Regenschauer;15;15;0
21/06/2019;23:00;206;71;135;Leichter Regenschauer;14;14;0
22/06/2019;00:00;162;43;119;Leichter Regenschauer;14;14;0
22/06/2019;01:00;107;36;71;Leichter Regenschauer;14;13;0
22/06/2019;02:00;78;44;34;Stellenweiser Regenfall;14;13;0
22/06/2019;03:00;38;21;17;Stellenweiser Regenfall;14;13;0
22/06/2019;04:00;20;8;12;Stellenweiser Regenfall;14;14;0
22/06/2019;05:00;36;19;17;Leichter Regenschauer;14;14;0
22/06/2019;06:00;41;25;16;Leichter Regenschauer;15;15;0
22/06/2019;07:00;85;53;32;Leichter Regenschauer;15;15;0
22/06/2019;08:00;176;114;62;Mäßiger bis starker Regenschauer;16;16;0
22/06/2019;09:00;354;225;129;Mäßiger bis starker Regenschauer;16;16;0
22/06/2019;10:00;429;251;178;Mäßiger bis starker Regenschauer;18;18;0
22/06/2019;11:00;490;301;189;Leichter Regenschauer;19;19;0
22/06/2019;12:00;517;288;229;Leichter Regenschauer;20;20;0
22/06/2019;13:00;527;276;251;Leichter Regenschauer;21;21;0
22/06/2019;14:00;484;257;227;Leicht bewölkt;21;21;0
22/06/2019;15:00;449;221;228;Leicht bewölkt;21;21;0
22/06/2019;16:00;555;268;287;Leicht bewölkt;21;21;0
22/06/2019;17:00;541;262;279;Mäßiger bis starker Regenschauer;20;20;0
22/06/2019;18:00;462;211;251;Mäßiger bis starker Regenschauer;20;20;0
22/06/2019;19:00;395;184;211;Mäßiger bis starker Regenschauer;19;19;0
22/06/2019;20:00;317;149;168;Stellenweiser Regenfall;18;18;0
22/06/2019;21:00;283;140;143;Stellenweiser Regenfall;16;17;0
22/06/2019;22:00;205;97;108;Stellenweiser Regenfall;16;16;0
22/06/2019;23:00;206;83;123;Leichter Regenschauer;15;15;0
23/06/2019;00:00;141;51;90;Leichter Regenschauer;15;15;0
23/06/2019;01:00;99;28;71;Leichter Regenschauer;14;14;0
23/06/2019;02:00;65;14;51;Leichter Nebel;14;14;0
23/06/2019;03:00;48;12;36;Leichter Nebel;14;14;0
23/06/2019;04:00;30;11;19;Leichter Nebel;14;15;0
23/06/2019;05:00;21;11;10;Leichter Nebel;15;15;0
23/06/2019;06:00;37;17;20;Leichter Nebel;15;15;0
23/06/2019;07:00;55;35;20;Leichter Nebel;16;17;0
23/06/2019;08:00;123;67;56;Bewölkt;18;18;0
23/06/2019;09:00;273;159;114;Bewölkt;19;19;0
23/06/2019;10:00;362;195;167;Bewölkt;20;20;0
23/06/2019;11:00;403;186;217;Leicht bewölkt;21;21;0
23/06/2019;12:00;457;221;236;Leicht bewölkt;22;24;0
23/06/2019;13:00;527;243;284;Leicht bewölkt;23;24;0
23/06/2019;14:00;554;272;282;Leicht bewölkt;24;25;0
23/06/2019;15:00;541;277;264;Leicht bewölkt;24;26;0
23/06/2019;16:00;507;261;246;Leicht bewölkt;24;25;0
23/06/2019;17:00;610;314;296;Leicht bewölkt;23;25;0
23/06/2019;18:00;644;310;334;Leicht bewölkt;23;25;0
23/06/2019;19:00;581;272;309;Leicht bewölkt;22;24;0
23/06/2019;20:00;428;202;226;Leicht bewölkt;21;21;0
23/06/2019;21:00;341;138;203;Leicht bewölkt;20;20;0
23/06/2019;22:00;205;90;115;Leicht bewölkt;19;19;0
23/06/2019;23:00;108;49;59;Leicht bewölkt;18;18;0
24/06/2019;00:00;55;21;34;Leicht bewölkt;16;16;0
24/06/2019;01:00;32;18;14;Leicht bewölkt;16;16;0
24/06/2019;02:00;3;0;3;Leichter Nebel;15;15;0
24/06/2019;03:00;2;0;2;Leichter Nebel;14;14;0
24/06/2019;04:00;8;6;2;Leichter Nebel;15;15;0
24/06/2019;05:00;65;40;25;Leichter Nebel;17;17;0
24/06/2019;06:00;222;135;87;Leichter Nebel;18;18;0
24/06/2019;07:00;1131;732;399;Leichter Nebel;20;20;0
24/06/2019;08:00;871;496;375;Leicht bewölkt;21;21;0
24/06/2019;09:00;863;549;314;Leicht bewölkt;23;24;0
24/06/2019;10:00;563;347;216;Leicht bewölkt;25;26;0
24/06/2019;11:00;828;394;434;Leicht bewölkt;26;27;0
24/06/2019;12:00;745;314;431;Leicht bewölkt;27;28;0
24/06/2019;13:00;1094;464;630;Leicht bewölkt;27;29;0
24/06/2019;14:00;810;383;427;Leicht bewölkt;28;29;0
24/06/2019;15:00;1083;475;608;Leicht bewölkt;28;30;0
24/06/2019;16:00;1067;542;525;Leicht bewölkt;27;29;0
24/06/2019;17:00;1275;594;681;Leicht bewölkt;27;29;0
24/06/2019;18:00;1035;516;519;Leicht bewölkt;26;28;0
24/06/2019;19:00;931;431;500;Leicht bewölkt;25;26;0
24/06/2019;20:00;661;287;374;Sonnig;23;25;0
24/06/2019;21:00;569;191;378;Sonnig;22;23;0
24/06/2019;22:00;366;124;242;Sonnig;21;21;0
24/06/2019;23:00;195;63;132;Sonnig;21;21;0
25/06/2019;00:00;81;24;57;Sonnig;20;20;0
25/06/2019;01:00;34;16;18;Sonnig;19;19;0
25/06/2019;02:00;8;4;4;Sonnig;19;19;0
25/06/2019;03:00;4;3;1;Sonnig;18;18;0
25/06/2019;04:00;3;2;1;Sonnig;19;19;0
25/06/2019;05:00;57;40;17;Leicht bewölkt;20;20;0
25/06/2019;06:00;248;160;88;Leicht bewölkt;21;21;0
25/06/2019;07:00;1246;837;409;Leicht bewölkt;22;24;0
25/06/2019;08:00;1009;572;437;Leicht bewölkt;24;26;0
25/06/2019;09:00;934;582;352;Leicht bewölkt;25;27;0
25/06/2019;10:00;595;338;257;Leicht bewölkt;27;29;0
25/06/2019;11:00;813;379;434;Leicht bewölkt;29;31;0
25/06/2019;12:00;832;329;503;Leicht bewölkt;30;33;0
25/06/2019;13:00;1016;430;586;Leicht bewölkt;31;33;0
25/06/2019;14:00;696;328;368;Leicht bewölkt;31;34;0
25/06/2019;15:00;1156;502;654;Leicht bewölkt;31;34;0
25/06/2019;16:00;1171;541;630;Leicht bewölkt;30;34;0
25/06/2019;17:00;1283;627;656;Leicht bewölkt;30;33;0
25/06/2019;18:00;1192;534;658;Leicht bewölkt;29;32;0
25/06/2019;19:00;1023;488;535;Leicht bewölkt;27;31;0
25/06/2019;20:00;731;351;380;Leicht bewölkt;26;29;0
25/06/2019;21:00;613;218;395;Leicht bewölkt;25;27;0
25/06/2019;22:00;455;163;292;Leicht bewölkt;24;27;0
25/06/2019;23:00;222;75;147;Leicht bewölkt;23;26;0
26/06/2019;00:00;112;40;72;Leicht bewölkt;22;25;0
26/06/2019;01:00;44;18;26;Leicht bewölkt;21;21;0
26/06/2019;02:00;25;13;12;Leicht bewölkt;20;20;0
26/06/2019;03:00;2;2;0;Leicht bewölkt;19;19;0
26/06/2019;04:00;9;4;5;Leicht bewölkt;20;20;0
26/06/2019;05:00;67;45;22;Leicht bewölkt;20;20;0
26/06/2019;06:00;236;150;86;Leicht bewölkt;21;21;0
26/06/2019;07:00;1283;867;416;Leicht bewölkt;23;25;0
26/06/2019;08:00;987;602;385;Leicht bewölkt;25;27;0
26/06/2019;09:00;980;577;403;Leicht bewölkt;27;30;0
26/06/2019;10:00;582;304;278;Leicht bewölkt;29;31;0
26/06/2019;11:00;694;304;390;Leicht bewölkt;30;33;0
26/06/2019;12:00;801;352;449;Leicht bewölkt;32;35;0
26/06/2019;13:00;1084;459;625;Leicht bewölkt;32;35;0
26/06/2019;14:00;768;331;437;Leicht bewölkt;32;36;0
26/06/2019;15:00;971;429;542;Leicht bewölkt;32;36;0
26/06/2019;16:00;951;427;524;Leicht bewölkt;32;37;0
26/06/2019;17:00;1238;530;708;Leicht bewölkt;31;37;0
26/06/2019;18:00;1143;541;602;Leicht bewölkt;31;37;0
26/06/2019;19:00;927;491;436;Leicht bewölkt;30;35;0
26/06/2019;20:00;830;416;414;Leicht bewölkt;29;34;0
26/06/2019;21:00;646;256;390;Leicht bewölkt;28;32;0
26/06/2019;22:00;493;148;345;Leicht bewölkt;26;30;0
26/06/2019;23:00;287;90;197;Sonnig;25;28;0
27/06/2019;00:00;143;39;104;Sonnig;24;26;0
27/06/2019;01:00;60;17;43;Sonnig;23;26;0
27/06/2019;02:00;22;8;14;Sonnig;22;25;0
27/06/2019;03:00;9;6;3;Sonnig;22;22;0
27/06/2019;04:00;12;7;5;Sonnig;23;25;0
27/06/2019;05:00;70;51;19;Sonnig;23;26;0
27/06/2019;06:00;221;152;69;Sonnig;24;27;0
27/06/2019;07:00;1247;822;425;Sonnig;26;29;0
27/06/2019;08:00;983;583;400;Sonnig;28;31;0
27/06/2019;09:00;947;569;378;Sonnig;29;33;0
27/06/2019;10:00;586;332;254;Sonnig;30;35;0
27/06/2019;11:00;723;350;373;Leicht bewölkt;31;36;0
27/06/2019;12:00;782;310;472;Leicht bewölkt;32;37;0
27/06/2019;13:00;1088;409;679;Leicht bewölkt;32;37;0
27/06/2019;14:00;699;347;352;Leicht bewölkt;32;36;0
27/06/2019;15:00;976;432;544;Leicht bewölkt;31;36;0
27/06/2019;16:00;1069;507;562;Leicht bewölkt;30;35;0
27/06/2019;17:00;1349;621;728;Stellenweiser Regenfall;29;33;0
27/06/2019;18:00;1175;572;603;Stellenweiser Regenfall;28;32;0
27/06/2019;19:00;942;452;490;Stellenweiser Regenfall;27;30;0
27/06/2019;20:00;641;305;336;Nieselregen mit Gewitter;25;29;0
27/06/2019;21:00;592;239;353;Nieselregen mit Gewitter;24;27;0
27/06/2019;22:00;519;182;337;Nieselregen mit Gewitter;22;24;0
27/06/2019;23:00;268;66;202;Nieselregen mit Gewitter;20;20;0
28/06/2019;00:00;114;30;84;Nieselregen mit Gewitter;18;18;0
28/06/2019;01:00;48;15;33;Nieselregen mit Gewitter;17;17;0
28/06/2019;02:00;17;8;9;Stellenweiser Regenfall;16;16;0
28/06/2019;03:00;7;5;2;Stellenweiser Regenfall;15;15;0
28/06/2019;04:00;7;4;3;Stellenweiser Regenfall;16;16;0
28/06/2019;05:00;65;41;24;Leicht bewölkt;17;17;0
28/06/2019;06:00;197;129;68;Leicht bewölkt;18;18;0
28/06/2019;07:00;1070;710;360;Leicht bewölkt;20;20;0
28/06/2019;08:00;913;541;372;Sonnig;22;22;0
28/06/2019;09:00;874;502;372;Sonnig;23;24;0
28/06/2019;10:00;678;368;310;Sonnig;24;25;0
28/06/2019;11:00;724;360;364;Sonnig;25;26;0
28/06/2019;12:00;875;398;477;Sonnig;26;27;0
28/06/2019;13:00;1099;409;690;Sonnig;26;27;0
28/06/2019;14:00;844;406;438;Sonnig;26;27;0
28/06/2019;15:00;888;425;463;Sonnig;27;28;0
28/06/2019;16:00;963;476;487;Sonnig;26;27;0
28/06/2019;17:00;885;428;457;Sonnig;25;26;0
28/06/2019;18:00;900;430;470;Sonnig;24;26;0
28/06/2019;19:00;844;388;456;Sonnig;22;24;0
28/06/2019;20:00;636;304;332;Sonnig;21;21;0
28/06/2019;21:00;638;283;355;Sonnig;19;19;0
28/06/2019;22:00;442;210;232;Sonnig;19;19;0
28/06/2019;23:00;319;120;199;Sonnig;18;18;0
29/06/2019;00:00;245;77;168;Sonnig;17;17;0
29/06/2019;01:00;174;57;117;Sonnig;17;17;0
29/06/2019;02:00;69;21;48;Sonnig;16;16;0
29/06/2019;03:00;45;14;31;Sonnig;15;16;0
29/06/2019;04:00;28;13;15;Sonnig;17;17;0
29/06/2019;05:00;30;22;8;Leicht bewölkt;18;18;0
29/06/2019;06:00;75;47;28;Leicht bewölkt;19;19;0
29/06/2019;07:00;167;89;78;Leicht bewölkt;21;21;0
29/06/2019;08:00;341;188;153;Leicht bewölkt;22;24;0
29/06/2019;09:00;612;363;249;Leicht bewölkt;24;26;0
29/06/2019;10:00;655;374;281;Leicht bewölkt;25;27;0
29/06/2019;11:00;667;350;317;Sonnig;26;28;0
29/06/2019;12:00;693;341;352;Sonnig;28;29;0
29/06/2019;13:00;729;372;357;Sonnig;28;29;0
29/06/2019;14:00;653;292;361;Sonnig;28;30;0
29/06/2019;15:00;652;328;324;Sonnig;29;30;0
29/06/2019;16:00;705;380;325;Sonnig;28;30;0
29/06/2019;17:00;671;386;285;Sonnig;27;30;0
29/06/2019;18:00;679;417;262;Sonnig;26;29;0
29/06/2019;19:00;456;301;155;Sonnig;25;27;0
29/06/2019;20:00;301;186;115;Sonnig;23;25;0
29/06/2019;21:00;258;138;120;Sonnig;22;22;0
29/06/2019;22:00;267;104;163;Sonnig;21;21;0
29/06/2019;23:00;220;81;139;Sonnig;20;20;0
30/06/2019;00:00;243;65;178;Sonnig;19;19;0
30/06/2019;01:00;227;35;192;Sonnig;19;19;0
30/06/2019;02:00;142;33;109;Sonnig;19;19;0
30/06/2019;03:00;91;14;77;Sonnig;19;19;0
30/06/2019;04:00;42;15;27;Sonnig;20;20;0
30/06/2019;05:00;42;26;16;Leicht bewölkt;21;21;0
30/06/2019;06:00;95;53;42;Leicht bewölkt;22;22;0
30/06/2019;07:00;143;93;50;Leicht bewölkt;24;25;0
30/06/2019;08:00;249;149;100;Sonnig;25;27;0
30/06/2019;09:00;404;236;168;Sonnig;27;29;0
30/06/2019;10:00;334;191;143;Sonnig;29;31;0
30/06/2019;11:00;382;193;189;Sonnig;30;32;0
30/06/2019;12:00;357;150;207;Sonnig;31;33;0
30/06/2019;13:00;342;177;165;Sonnig;32;34;0
30/06/2019;14:00;403;184;219;Sonnig;32;34;0
30/06/2019;15:00;364;165;199;Sonnig;33;35;0
30/06/2019;16:00;380;175;205;Sonnig;32;34;0
30/06/2019;17:00;475;209;266;Leicht bewölkt;32;34;0
30/06/2019;18:00;545;271;274;Leicht bewölkt;31;34;0
30/06/2019;19:00;541;263;278;Leicht bewölkt;30;33;0
30/06/2019;20:00;482;217;265;Sonnig;29;32;0
30/06/2019;21:00;401;147;254;Sonnig;28;31;0
30/06/2019;22:00;269;106;163;Sonnig;26;29;0
30/06/2019;23:00;142;59;83;Leicht bewölkt;24;26;0
01/07/2019;00:00;78;32;46;Leicht bewölkt;23;24;0
01/07/2019;01:00;32;12;20;Leicht bewölkt;21;21;0
01/07/2019;02:00;20;9;11;Leicht bewölkt;20;20;0
01/07/2019;03:00;7;4;3;Leicht bewölkt;19;19;0
01/07/2019;04:00;13;8;5;Leicht bewölkt;19;19;0
01/07/2019;05:00;68;51;17;Teilweise mäßiger Regenfall;20;20;0
01/07/2019;06:00;194;119;75;Teilweise mäßiger Regenfall;21;21;0
01/07/2019;07:00;1084;708;376;Teilweise mäßiger Regenfall;22;24;0
01/07/2019;08:00;861;497;364;Nieselregen mit Gewitter;24;26;0
01/07/2019;09:00;827;503;324;Nieselregen mit Gewitter;26;28;0
01/07/2019;10:00;532;283;249;Nieselregen mit Gewitter;27;30;0
01/07/2019;11:00;726;335;391;Nieselregen mit Gewitter;29;31;0
01/07/2019;12:00;698;309;389;Nieselregen mit Gewitter;30;32;0
01/07/2019;13:00;895;328;567;Nieselregen mit Gewitter;30;32;0
01/07/2019;14:00;720;368;352;Stellenweiser Regenfall;31;33;0
01/07/2019;15:00;869;431;438;Stellenweiser Regenfall;31;33;0
01/07/2019;16:00;832;367;465;Stellenweiser Regenfall;30;32;0
01/07/2019;17:00;945;395;550;Teilweise mäßiger Regenfall;30;32;0
01/07/2019;18:00;904;409;495;Teilweise mäßiger Regenfall;29;31;1
01/07/2019;19:00;725;295;430;Teilweise mäßiger Regenfall;28;30;0
01/07/2019;20:00;558;213;345;Mäßiger bis starker Regenschauer;27;30;1
01/07/2019;21:00;401;139;262;Mäßiger bis starker Regenschauer;26;29;1
01/07/2019;22:00;314;94;220;Mäßiger bis starker Regenschauer;24;26;0
01/07/2019;23:00;140;48;92;Mäßiger bis starker Regenschauer;21;21;1
02/07/2019;00:00;67;38;29;Mäßiger bis starker Regenschauer;19;19;1
02/07/2019;01:00;32;6;26;Mäßiger bis starker Regenschauer;18;18;1
02/07/2019;02:00;12;6;6;Mäßiger bis starker Regenschauer;17;17;1
02/07/2019;03:00;6;3;3;Mäßiger bis starker Regenschauer;16;16;1
02/07/2019;04:00;12;8;4;Mäßiger bis starker Regenschauer;16;16;0
02/07/2019;05:00;55;34;21;Mäßiger bis starker Regenschauer;17;17;1
02/07/2019;06:00;186;115;71;Mäßiger bis starker Regenschauer;18;18;1
02/07/2019;07:00;954;585;369;Mäßiger bis starker Regenschauer;19;19;0
02/07/2019;08:00;889;484;405;Mäßiger bis starker Regenschauer;20;20;0
02/07/2019;09:00;792;476;316;Mäßiger bis starker Regenschauer;21;21;0
02/07/2019;10:00;554;309;245;Mäßiger bis starker Regenschauer;22;22;0
02/07/2019;11:00;701;333;368;Leicht bewölkt;23;24;0
02/07/2019;12:00;744;297;447;Leicht bewölkt;24;25;0
02/07/2019;13:00;895;373;522;Leicht bewölkt;24;25;0
02/07/2019;14:00;755;364;391;Leicht bewölkt;24;25;0
02/07/2019;15:00;1044;483;561;Leicht bewölkt;24;26;0
02/07/2019;16:00;1028;520;508;Leicht bewölkt;23;25;0
02/07/2019;17:00;1307;591;716;Stellenweiser Regenfall;23;24;0
02/07/2019;18:00;1127;514;613;Stellenweiser Regenfall;22;22;0
02/07/2019;19:00;946;440;506;Stellenweiser Regenfall;21;21;0
02/07/2019;20:00;674;320;354;Stellenweiser Regenfall;20;20;0
02/07/2019;21:00;498;197;301;Stellenweiser Regenfall;18;18;0
02/07/2019;22:00;395;140;255;Stellenweiser Regenfall;17;17;0
02/07/2019;23:00;200;73;127;Leicht bewölkt;16;16;0
03/07/2019;00:00;92;44;48;Leicht bewölkt;15;15;0
03/07/2019;01:00;45;14;31;Leicht bewölkt;14;14;0
03/07/2019;02:00;34;13;21;Leicht bewölkt;14;13;0
03/07/2019;03:00;6;4;2;Leicht bewölkt;13;12;0
03/07/2019;04:00;18;11;7;Leicht bewölkt;14;13;0
03/07/2019;05:00;66;47;19;Stellenweiser Regenfall;14;14;0
03/07/2019;06:00;207;118;89;Stellenweiser Regenfall;15;15;0
03/07/2019;07:00;1250;802;448;Stellenweiser Regenfall;16;16;0
03/07/2019;08:00;933;522;411;Stellenweiser Regenfall;18;18;0
03/07/2019;09:00;749;414;335;Stellenweiser Regenfall;19;19;0
03/07/2019;10:00;542;323;219;Stellenweiser Regenfall;20;20;0
03/07/2019;11:00;618;246;372;Leicht bewölkt;21;21;0
03/07/2019;12:00;778;316;462;Leicht bewölkt;22;24;0
03/07/2019;13:00;1046;440;606;Leicht bewölkt;23;24;0
03/07/2019;14:00;762;320;442;Leicht bewölkt;23;25;0
03/07/2019;15:00;947;445;502;Leicht bewölkt;23;25;0
03/07/2019;16:00;1106;551;555;Leicht bewölkt;22;24;0
03/07/2019;17:00;1272;551;721;Leicht bewölkt;22;22;0
03/07/2019;18:00;1177;532;645;Leicht bewölkt;21;21;0
03/07/2019;19:00;887;436;451;Leicht bewölkt;19;19;0
03/07/2019;20:00;692;327;365;Stellenweiser Regenfall;18;18;0
03/07/2019;21:00;576;244;332;Stellenweiser Regenfall;17;17;0
03/07/2019;22:00;476;202;274;Stellenweiser Regenfall;16;15;0
03/07/2019;23:00;245;90;155;Leicht bewölkt;15;14;0
04/07/2019;00:00;131;46;85;Leicht bewölkt;14;13;0
04/07/2019;01:00;93;31;62;Leicht bewölkt;13;12;0
04/07/2019;02:00;28;16;12;Leicht bewölkt;13;12;0
04/07/2019;03:00;13;7;6;Leicht bewölkt;12;11;0
04/07/2019;04:00;12;6;6;Leicht bewölkt;13;12;0
04/07/2019;05:00;60;40;20;Leicht bewölkt;14;13;0
04/07/2019;06:00;203;122;81;Leicht bewölkt;14;14;0
04/07/2019;07:00;1046;652;394;Leicht bewölkt;16;16;0
04/07/2019;08:00;903;552;351;Leicht bewölkt;17;17;0
04/07/2019;09:00;920;540;380;Leicht bewölkt;19;19;0
04/07/2019;10:00;642;369;273;Leicht bewölkt;20;20;0
04/07/2019;11:00;732;375;357;Leicht bewölkt;21;21;0
04/07/2019;12:00;792;330;462;Leicht bewölkt;23;24;0
04/07/2019;13:00;1037;449;588;Leicht bewölkt;23;24;0
04/07/2019;14:00;756;372;384;Sonnig;23;25;0
04/07/2019;15:00;1037;496;541;Sonnig;24;25;0
04/07/2019;16:00;1092;541;551;Sonnig;23;25;0
04/07/2019;17:00;1247;573;674;Leicht bewölkt;23;25;0
04/07/2019;18:00;1179;559;620;Leicht bewölkt;22;25;0
04/07/2019;19:00;885;407;478;Leicht bewölkt;21;21;0
04/07/2019;20:00;681;290;391;Leicht bewölkt;20;20;0
04/07/2019;21:00;580;239;341;Leicht bewölkt;19;19;0
04/07/2019;22:00;473;201;272;Leicht bewölkt;18;18;0
04/07/2019;23:00;244;104;140;Leicht bewölkt;17;17;0
05/07/2019;00:00;156;49;107;Leicht bewölkt;16;16;0
05/07/2019;01:00;61;22;39;Leicht bewölkt;15;15;0
05/07/2019;02:00;23;11;12;Leicht bewölkt;15;15;0
05/07/2019;03:00;9;2;7;Leicht bewölkt;14;14;0
05/07/2019;04:00;19;11;8;Leicht bewölkt;15;15;0
05/07/2019;05:00;66;43;23;Leicht bewölkt;16;16;0
05/07/2019;06:00;177;109;68;Leicht bewölkt;17;17;0
05/07/2019;07:00;1056;684;372;Leicht bewölkt;19;19;0
05/07/2019;08:00;941;548;393;Leicht bewölkt;21;21;0
05/07/2019;09:00;884;550;334;Leicht bewölkt;23;24;0
05/07/2019;10:00;670;385;285;Leicht bewölkt;24;25;0
05/07/2019;11:00;773;384;389;Leicht bewölkt;25;26;0
05/07/2019;12:00;982;464;518;Leicht bewölkt;26;27;0
05/07/2019;13:00;1186;414;772;Leicht bewölkt;27;28;0
05/07/2019;14:00;881;391;490;Stellenweiser Regenfall;28;28;0
05/07/2019;15:00;911;441;470;Stellenweiser Regenfall;28;29;0
05/07/2019;16:00;848;425;423;Stellenweiser Regenfall;28;28;0
05/07/2019;17:00;1010;499;511;Leicht bewölkt;27;28;0
05/07/2019;18:00;1152;587;565;Leicht bewölkt;26;27;0
05/07/2019;19:00;943;537;406;Leicht bewölkt;25;26;0
05/07/2019;20:00;798;483;315;Leicht bewölkt;24;25;0
05/07/2019;21:00;582;291;291;Leicht bewölkt;22;24;0
05/07/2019;22:00;603;230;373;Leicht bewölkt;21;21;0
05/07/2019;23:00;430;96;334;Leicht bewölkt;19;19;0
06/07/2019;00:00;350;77;273;Leicht bewölkt;17;17;0
06/07/2019;01:00;158;34;124;Leicht bewölkt;16;16;0
06/07/2019;02:00;123;19;104;Leicht bewölkt;16;16;0
06/07/2019;03:00;60;19;41;Leicht bewölkt;15;15;0
06/07/2019;04:00;34;13;21;Leicht bewölkt;16;16;0
06/07/2019;05:00;36;20;16;Leicht bewölkt;17;17;0
06/07/2019;06:00;54;30;24;Leicht bewölkt;18;18;0
06/07/2019;07:00;146;70;76;Leicht bewölkt;20;20;0
06/07/2019;08:00;358;221;137;Leicht bewölkt;22;22;0
06/07/2019;09:00;595;406;189;Leicht bewölkt;24;24;0
06/07/2019;10:00;701;396;305;Leicht bewölkt;25;26;0
06/07/2019;11:00;869;473;396;Leicht bewölkt;26;27;0
06/07/2019;12:00;721;399;322;Leicht bewölkt;28;29;0
06/07/2019;13:00;717;322;395;Leicht bewölkt;28;29;0
06/07/2019;14:00;717;355;362;Leicht bewölkt;29;29;0
06/07/2019;15:00;811;387;424;Leicht bewölkt;29;29;0
06/07/2019;16:00;710;288;422;Leicht bewölkt;28;29;0
06/07/2019;17:00;505;253;252;Leicht bewölkt;27;28;0
06/07/2019;18:00;593;268;325;Leicht bewölkt;26;28;0
06/07/2019;19:00;536;225;311;Leicht bewölkt;25;27;0
06/07/2019;20:00;467;219;248;Leichter Regenschauer;24;26;0
06/07/2019;21:00;431;207;224;Leichter Regenschauer;23;25;1
06/07/2019;22:00;300;122;178;Leichter Regenschauer;22;22;0
06/07/2019;23:00;263;124;139;Mäßiger bis starker Regenschauer;20;20;0
07/07/2019;00:00;211;57;154;Mäßiger bis starker Regenschauer;18;18;1
07/07/2019;01:00;149;60;89;Mäßiger bis starker Regenschauer;17;17;0
07/07/2019;02:00;63;27;36;Mäßiger bis starker Regenschauer;16;16;0
07/07/2019;03:00;38;18;20;Mäßiger bis starker Regenschauer;15;15;1
07/07/2019;04:00;27;12;15;Mäßiger bis starker Regenschauer;16;16;0
07/07/2019;05:00;25;11;14;Mäßiger bis starker Regenschauer;17;17;0
07/07/2019;06:00;22;15;7;Mäßiger bis starker Regenschauer;17;17;1
07/07/2019;07:00;23;9;14;Mäßiger bis starker Regenschauer;18;18;0
07/07/2019;08:00;58;28;30;Mäßiger bis starker Regenschauer;19;20;0
07/07/2019;09:00;206;118;88;Mäßiger bis starker Regenschauer;21;21;0
07/07/2019;10:00;293;156;137;Mäßiger bis starker Regenschauer;21;21;0
07/07/2019;11:00;379;229;150;Mäßiger bis starker Regenschauer;22;22;1
07/07/2019;12:00;378;189;189;Mäßiger bis starker Regenschauer;22;25;1
07/07/2019;13:00;462;232;230;Mäßiger bis starker Regenschauer;22;25;0
07/07/2019;14:00;545;240;305;Mäßiger bis starker Regenschauer;22;25;0
07/07/2019;15:00;253;140;113;Mäßiger bis starker Regenschauer;22;25;1
07/07/2019;16:00;445;207;238;Mäßiger bis starker Regenschauer;22;22;0
07/07/2019;17:00;341;174;167;Mäßiger bis starker Regenschauer;21;21;0
07/07/2019;18:00;404;208;196;Mäßiger bis starker Regenschauer;21;21;1
07/07/2019;19:00;362;191;171;Mäßiger bis starker Regenschauer;20;20;0
07/07/2019;20:00;361;170;191;Mäßiger bis starker Regenschauer;20;20;0
07/07/2019;21:00;244;118;126;Mäßiger bis starker Regenschauer;19;19;0
07/07/2019;22:00;162;63;99;Mäßiger bis starker Regenschauer;18;18;0
07/07/2019;23:00;106;40;66;Leichter Regenschauer;17;17;0
08/07/2019;00:00;55;11;44;Leichter Regenschauer;16;16;1
08/07/2019;01:00;26;8;18;Leichter Regenschauer;15;15;0
08/07/2019;02:00;5;3;2;Mäßiger bis starker Regenschauer;13;13;0
08/07/2019;03:00;5;3;2;Mäßiger bis starker Regenschauer;12;12;0
08/07/2019;04:00;6;4;2;Mäßiger bis starker Regenschauer;13;13;0
08/07/2019;05:00;40;31;9;Stellenweiser Regenfall;13;14;0
08/07/2019;06:00;192;123;69;Stellenweiser Regenfall;14;14;0
08/07/2019;07:00;1060;679;381;Stellenweiser Regenfall;15;15;0
08/07/2019;08:00;954;583;371;Stellenweiser Regenfall;15;16;0
08/07/2019;09:00;920;519;401;Stellenweiser Regenfall;16;16;0
08/07/2019;10:00;750;422;328;Stellenweiser Regenfall;17;17;0
08/07/2019;11:00;761;374;387;Leichter Regenschauer;18;18;0
08/07/2019;12:00;955;435;520;Leichter Regenschauer;19;19;0
08/07/2019;13:00;1232;518;714;Leichter Regenschauer;19;19;0
08/07/2019;14:00;962;502;460;Stellenweiser Regenfall;19;19;0
08/07/2019;15:00;1209;599;610;Stellenweiser Regenfall;19;19;0
08/07/2019;16:00;1294;574;720;Stellenweiser Regenfall;18;18;0
08/07/2019;17:00;1375;555;820;Leichter Regenschauer;17;17;0
08/07/2019;18:00;1264;536;728;Leichter Regenschauer;17;17;0
08/07/2019;19:00;896;403;493;Leichter Regenschauer;16;16;0
08/07/2019;20:00;642;302;340;Stellenweiser Regenfall;15;15;0
08/07/2019;21:00;455;192;263;Stellenweiser Regenfall;14;14;0
08/07/2019;22:00;360;120;240;Stellenweiser Regenfall;13;13;0
08/07/2019;23:00;175;78;97;Leicht bewölkt;12;12;0
09/07/2019;00:00;75;33;42;Leicht bewölkt;12;12;0
09/07/2019;01:00;39;20;19;Leicht bewölkt;11;11;0
09/07/2019;02:00;15;7;8;Leicht bewölkt;11;10;0
09/07/2019;03:00;8;4;4;Leicht bewölkt;10;9;0
09/07/2019;04:00;19;11;8;Leicht bewölkt;11;10;0
09/07/2019;05:00;80;58;22;Leicht bewölkt;11;10;0
09/07/2019;06:00;249;155;94;Leicht bewölkt;12;11;0
09/07/2019;07:00;1334;875;459;Leicht bewölkt;13;13;0
09/07/2019;08:00;1227;749;478;Leicht bewölkt;15;14;0
09/07/2019;09:00;667;391;276;Leicht bewölkt;16;16;0
09/07/2019;10:00;1;0;1;Leicht bewölkt;17;17;0
09/07/2019;11:00;0;0;0;Leicht bewölkt;18;18;0
09/07/2019;12:00;0;0;0;Leicht bewölkt;19;19;0
09/07/2019;13:00;0;0;0;Leicht bewölkt;19;19;0
09/07/2019;14:00;364;185;179;Leicht bewölkt;20;20;0
09/07/2019;15:00;1443;669;774;Leicht bewölkt;20;20;0
09/07/2019;16:00;1533;706;827;Leicht bewölkt;19;19;0
09/07/2019;17:00;1785;815;970;Leicht bewölkt;19;19;0
09/07/2019;18:00;1494;669;825;Leicht bewölkt;18;18;0
09/07/2019;19:00;1175;571;604;Leicht bewölkt;17;17;0
09/07/2019;20:00;805;367;438;Leicht bewölkt;17;17;0
09/07/2019;21:00;610;246;364;Leicht bewölkt;16;16;0
09/07/2019;22:00;514;183;331;Leicht bewölkt;14;14;0
09/07/2019;23:00;211;76;135;Leicht bewölkt;13;12;0
10/07/2019;00:00;107;44;63;Leicht bewölkt;11;10;0
10/07/2019;01:00;63;21;42;Leicht bewölkt;10;9;0
10/07/2019;02:00;14;5;9;Leicht bewölkt;9;8;0
10/07/2019;03:00;5;2;3;Leicht bewölkt;8;7;0
10/07/2019;04:00;13;10;3;Leicht bewölkt;9;8;0
10/07/2019;05:00;82;59;23;Leicht bewölkt;10;9;0
10/07/2019;06:00;297;189;108;Leicht bewölkt;11;10;0
10/07/2019;07:00;1506;960;546;Leicht bewölkt;12;11;0
10/07/2019;08:00;1269;776;493;Leicht bewölkt;14;13;0
10/07/2019;09:00;1157;683;474;Leicht bewölkt;15;15;0
10/07/2019;10:00;973;536;437;Leicht bewölkt;17;16;0
10/07/2019;11:00;1062;534;528;Leicht bewölkt;18;18;0
10/07/2019;12:00;1256;551;705;Leicht bewölkt;19;19;0
10/07/2019;13:00;1553;742;811;Leicht bewölkt;19;19;0
10/07/2019;14:00;1235;578;657;Leicht bewölkt;20;20;0
10/07/2019;15:00;1368;623;745;Leicht bewölkt;20;20;0
10/07/2019;16:00;1540;722;818;Leicht bewölkt;20;20;0
10/07/2019;17:00;1765;824;941;Leicht bewölkt;19;19;0
10/07/2019;18:00;1550;747;803;Leicht bewölkt;19;19;0
10/07/2019;19:00;1220;589;631;Leicht bewölkt;18;18;0
10/07/2019;20:00;792;386;406;Leicht bewölkt;16;16;0
10/07/2019;21:00;696;314;382;Leicht bewölkt;15;15;0
10/07/2019;22:00;579;208;371;Leicht bewölkt;14;14;0
10/07/2019;23:00;297;99;198;Leicht bewölkt;13;13;0
11/07/2019;00:00;129;39;90;Leicht bewölkt;12;12;0
11/07/2019;01:00;56;24;32;Leicht bewölkt;11;11;0
11/07/2019;02:00;35;14;21;Leicht bewölkt;11;11;0
11/07/2019;03:00;16;5;11;Leicht bewölkt;10;10;0
11/07/2019;04:00;16;9;7;Leicht bewölkt;12;12;0
11/07/2019;05:00;83;63;20;Leicht bewölkt;13;13;0
11/07/2019;06:00;256;165;91;Leicht bewölkt;14;14;0
11/07/2019;07:00;1331;832;499;Leicht bewölkt;15;15;0
11/07/2019;08:00;1263;710;553;Leicht bewölkt;17;17;0
11/07/2019;09:00;1064;665;399;Leicht bewölkt;18;18;0
11/07/2019;10:00;801;474;327;Leicht bewölkt;18;18;0
11/07/2019;11:00;960;472;488;Leicht bewölkt;17;17;0
11/07/2019;12:00;1104;495;609;Leicht bewölkt;17;17;0
11/07/2019;13:00;1202;551;651;Leicht bewölkt;16;16;0
11/07/2019;14:00;1023;505;518;Leichter Regenfall;16;16;0
11/07/2019;15:00;1184;532;652;Leichter Regenfall;15;15;0
11/07/2019;16:00;1075;530;545;Leichter Regenfall;14;14;0
11/07/2019;17:00;1339;606;733;Mäßiger Regenfall;13;13;0
11/07/2019;18:00;1292;598;694;Mäßiger Regenfall;12;12;0
11/07/2019;19:00;932;464;468;Mäßiger Regenfall;11;11;0
11/07/2019;20:00;665;313;352;Teilweise mäßiger Regenfall;10;10;0
11/07/2019;21:00;492;204;288;Teilweise mäßiger Regenfall;9;9;0
11/07/2019;22:00;514;194;320;Teilweise mäßiger Regenfall;10;10;0
11/07/2019;23:00;257;86;171;Bewölkt;11;11;0
12/07/2019;00:00;160;47;113;Bewölkt;11;11;0
12/07/2019;01:00;59;21;38;Bewölkt;11;11;0
12/07/2019;02:00;29;15;14;Bedeckt;11;12;0
12/07/2019;03:00;11;8;3;Bedeckt;12;12;0
12/07/2019;04:00;13;10;3;Bedeckt;12;13;0
12/07/2019;05:00;63;43;20;Leicht bewölkt;13;13;0
12/07/2019;06:00;239;159;80;Leicht bewölkt;14;14;0
12/07/2019;07:00;685;423;262;Leicht bewölkt;14;14;0
12/07/2019;08:00;666;399;267;Bedeckt;14;15;0
12/07/2019;09:00;535;330;205;Bedeckt;15;15;0
12/07/2019;10:00;358;202;156;Bedeckt;16;16;0
12/07/2019;11:00;374;192;182;Mäßiger Regenfall;17;17;0
12/07/2019;12:00;731;364;367;Mäßiger Regenfall;19;18;0
12/07/2019;13:00;879;391;488;Mäßiger Regenfall;19;19;0
12/07/2019;14:00;880;467;413;Stellenweise Gewitter und Niederschläge;20;20;0
12/07/2019;15:00;962;485;477;Stellenweise Gewitter und Niederschläge;20;20;0
12/07/2019;16:00;839;406;433;Stellenweise Gewitter und Niederschläge;20;20;0
12/07/2019;17:00;814;351;463;Mäßiger bis starker Regenschauer;19;19;1
12/07/2019;18:00;909;452;457;Mäßiger bis starker Regenschauer;18;18;1
12/07/2019;19:00;581;275;306;Mäßiger bis starker Regenschauer;17;17;0
12/07/2019;20:00;434;198;236;Sintflutartiger Regenfall;16;15;1
12/07/2019;21:00;334;135;199;Sintflutartiger Regenfall;15;14;1
12/07/2019;22:00;278;123;155;Sintflutartiger Regenfall;14;14;0
12/07/2019;23:00;200;64;136;Mäßiger bis starker Regenschauer;14;13;0
13/07/2019;00:00;168;45;123;Mäßiger bis starker Regenschauer;13;12;1
13/07/2019;01:00;124;50;74;Mäßiger bis starker Regenschauer;13;12;0
13/07/2019;02:00;54;20;34;Mäßiger bis starker Regenschauer;12;12;0
13/07/2019;03:00;45;15;30;Mäßiger bis starker Regenschauer;12;12;1
13/07/2019;04:00;29;17;12;Mäßiger bis starker Regenschauer;13;12;0
13/07/2019;05:00;33;20;13;Mäßiger bis starker Regenschauer;13;13;0
13/07/2019;06:00;79;57;22;Mäßiger bis starker Regenschauer;14;14;1
13/07/2019;07:00;156;101;55;Mäßiger bis starker Regenschauer;15;15;0
13/07/2019;08:00;394;258;136;Mäßiger bis starker Regenschauer;16;16;0
13/07/2019;09:00;680;411;269;Mäßiger bis starker Regenschauer;17;17;0
13/07/2019;10:00;911;586;325;Mäßiger bis starker Regenschauer;18;18;0
13/07/2019;11:00;1021;571;450;Stellenweiser Regenfall;19;19;0
13/07/2019;12:00;971;539;432;Stellenweiser Regenfall;20;20;0
13/07/2019;13:00;942;505;437;Stellenweiser Regenfall;20;20;0
13/07/2019;14:00;1010;485;525;Leicht bewölkt;20;20;0
13/07/2019;15:00;1001;466;535;Leicht bewölkt;21;21;0
13/07/2019;16:00;1009;460;549;Leicht bewölkt;20;20;0
13/07/2019;17:00;977;408;569;Stellenweiser Regenfall;20;20;0
13/07/2019;18:00;1013;505;508;Stellenweiser Regenfall;19;19;0
13/07/2019;19:00;872;440;432;Stellenweiser Regenfall;18;18;0
13/07/2019;20:00;620;289;331;Stellenweiser Regenfall;17;17;0
13/07/2019;21:00;481;228;253;Stellenweiser Regenfall;16;16;0
13/07/2019;22:00;392;144;248;Stellenweiser Regenfall;15;15;0
13/07/2019;23:00;331;117;214;Stellenweiser Regenfall;13;13;0
14/07/2019;00:00;244;88;156;Stellenweiser Regenfall;12;12;0
14/07/2019;01:00;174;72;102;Stellenweiser Regenfall;11;11;0
14/07/2019;02:00;77;35;42;Stellenweiser Regenfall;11;11;0
14/07/2019;03:00;50;19;31;Stellenweiser Regenfall;10;10;0
14/07/2019;04:00;30;15;15;Stellenweiser Regenfall;11;11;0
14/07/2019;05:00;44;24;20;Leicht bewölkt;12;12;0
14/07/2019;06:00;50;27;23;Leicht bewölkt;13;13;0
14/07/2019;07:00;108;63;45;Leicht bewölkt;14;14;0
14/07/2019;08:00;217;114;103;Leicht bewölkt;15;16;0
14/07/2019;09:00;479;284;195;Leicht bewölkt;17;17;0
14/07/2019;10:00;561;284;277;Leicht bewölkt;18;18;0
14/07/2019;11:00;745;402;343;Stellenweiser Regenfall;19;19;0
14/07/2019;12:00;747;364;383;Stellenweiser Regenfall;20;20;0
14/07/2019;13:00;759;367;392;Stellenweiser Regenfall;21;21;0
14/07/2019;14:00;908;423;485;Leicht bewölkt;21;21;0
14/07/2019;15:00;889;439;450;Leicht bewölkt;21;21;0
14/07/2019;16:00;876;430;446;Leicht bewölkt;21;21;0
14/07/2019;17:00;1003;501;502;Stellenweiser Regenfall;20;20;0
14/07/2019;18:00;761;372;389;Stellenweiser Regenfall;19;19;0
14/07/2019;19:00;612;302;310;Stellenweiser Regenfall;18;18;0
14/07/2019;20:00;458;232;226;Leicht bewölkt;17;16;0
14/07/2019;21:00;324;149;175;Leicht bewölkt;15;14;0
14/07/2019;22:00;203;89;114;Leicht bewölkt;14;13;0
14/07/2019;23:00;104;43;61;Leichter Regenschauer;14;12;0
15/07/2019;00:00;58;20;38;Leichter Regenschauer;13;12;0
15/07/2019;01:00;13;4;9;Leichter Regenschauer;12;11;0
15/07/2019;02:00;17;6;11;Leicht bewölkt;11;10;0
15/07/2019;03:00;10;3;7;Leicht bewölkt;11;10;0
15/07/2019;04:00;8;6;2;Leicht bewölkt;11;10;0
15/07/2019;05:00;70;49;21;Leichter Nebel;12;11;0
15/07/2019;06:00;271;176;95;Leichter Nebel;12;11;0
15/07/2019;07:00;1330;888;442;Leichter Nebel;13;12;0
15/07/2019;08:00;1143;720;423;Bedeckt;14;13;0
15/07/2019;09:00;1009;569;440;Bedeckt;15;15;0
15/07/2019;10:00;890;499;391;Bedeckt;17;16;0
15/07/2019;11:00;988;468;520;Bewölkt;18;18;0
15/07/2019;12:00;1089;521;568;Bewölkt;20;20;0
15/07/2019;13:00;1294;587;707;Bewölkt;20;20;0
15/07/2019;14:00;1081;539;542;Leicht bewölkt;21;21;0
15/07/2019;15:00;1485;736;749;Leicht bewölkt;22;25;0
15/07/2019;16:00;1468;647;821;Leicht bewölkt;21;21;0
15/07/2019;17:00;1649;766;883;Stellenweiser Regenfall;20;20;0
15/07/2019;18:00;1507;681;826;Stellenweiser Regenfall;20;20;0
15/07/2019;19:00;1164;572;592;Stellenweiser Regenfall;19;19;0
15/07/2019;20:00;821;346;475;Leicht bewölkt;18;18;0
15/07/2019;21:00;590;243;347;Leicht bewölkt;17;17;0
15/07/2019;22:00;392;147;245;Leicht bewölkt;16;16;0
15/07/2019;23:00;198;67;131;Stellenweiser Regenfall;14;14;0
16/07/2019;00:00;94;29;65;Stellenweiser Regenfall;13;13;0
16/07/2019;01:00;50;15;35;Stellenweiser Regenfall;12;13;0
16/07/2019;02:00;25;16;9;Leichter Nebel;12;12;0
16/07/2019;03:00;14;8;6;Leichter Nebel;11;12;0
16/07/2019;04:00;10;6;4;Leichter Nebel;12;12;0
16/07/2019;05:00;92;64;28;Leichter Nebel;13;13;0
16/07/2019;06:00;283;173;110;Leichter Nebel;14;14;0
16/07/2019;07:00;1397;934;463;Leichter Nebel;15;15;0
16/07/2019;08:00;1302;790;512;Leichter Nebel;17;17;0
16/07/2019;09:00;1305;770;535;Leichter Nebel;19;19;0
16/07/2019;10:00;1005;567;438;Leichter Nebel;21;21;0
16/07/2019;11:00;1199;595;604;Leicht bewölkt;22;23;0
16/07/2019;12:00;1308;531;777;Leicht bewölkt;24;24;0
16/07/2019;13:00;1436;615;821;Leicht bewölkt;24;25;0
16/07/2019;14:00;1220;571;649;Leicht bewölkt;25;25;0
16/07/2019;15:00;1536;726;810;Leicht bewölkt;25;26;0
16/07/2019;16:00;1629;773;856;Leicht bewölkt;24;26;0
16/07/2019;17:00;1815;855;960;Leicht bewölkt;23;25;0
16/07/2019;18:00;1703;779;924;Leicht bewölkt;23;25;0
16/07/2019;19:00;1289;636;653;Leicht bewölkt;21;21;0
16/07/2019;20:00;990;494;496;Leicht bewölkt;20;20;0
16/07/2019;21:00;718;318;400;Leicht bewölkt;19;19;0
16/07/2019;22:00;485;170;315;Leicht bewölkt;18;18;0
16/07/2019;23:00;314;86;228;Leicht bewölkt;16;16;0
17/07/2019;00:00;117;45;72;Leicht bewölkt;15;15;0
17/07/2019;01:00;61;20;41;Leicht bewölkt;14;14;0
17/07/2019;02:00;32;20;12;Leicht bewölkt;13;13;0
17/07/2019;03:00;13;7;6;Leicht bewölkt;13;13;0
17/07/2019;04:00;16;7;9;Leicht bewölkt;13;13;0
17/07/2019;05:00;98;73;25;Leicht bewölkt;14;14;0
17/07/2019;06:00;292;182;110;Leicht bewölkt;15;15;0
17/07/2019;07:00;1398;872;526;Leicht bewölkt;17;17;0
17/07/2019;08:00;1273;788;485;Leicht bewölkt;19;19;0
17/07/2019;09:00;1201;743;458;Leicht bewölkt;21;21;0
17/07/2019;10:00;935;526;409;Leicht bewölkt;22;22;0
17/07/2019;11:00;1088;549;539;Leicht bewölkt;23;24;0
17/07/2019;12:00;1288;593;695;Leicht bewölkt;24;26;0
17/07/2019;13:00;1531;624;907;Leicht bewölkt;25;26;0
17/07/2019;14:00;1238;571;667;Leicht bewölkt;25;26;0
17/07/2019;15:00;1405;682;723;Leicht bewölkt;25;26;0
17/07/2019;16:00;1592;761;831;Leicht bewölkt;24;25;0
17/07/2019;17:00;1815;874;941;Stellenweiser Regenfall;23;24;0
17/07/2019;18:00;1746;955;791;Stellenweiser Regenfall;22;23;0
17/07/2019;19:00;1304;675;629;Stellenweiser Regenfall;21;21;0
17/07/2019;20:00;931;447;484;Stellenweiser Regenfall;19;19;0
17/07/2019;21:00;799;310;489;Stellenweiser Regenfall;18;18;0
17/07/2019;22:00;663;232;431;Stellenweiser Regenfall;17;17;0
17/07/2019;23:00;325;119;206;Leicht bewölkt;16;16;0
18/07/2019;00:00;171;60;111;Leicht bewölkt;14;14;0
18/07/2019;01:00;60;15;45;Leicht bewölkt;14;14;0
18/07/2019;02:00;28;12;16;Stellenweiser Regenfall;13;13;0
18/07/2019;03:00;23;14;9;Stellenweiser Regenfall;13;13;0
18/07/2019;04:00;15;9;6;Stellenweiser Regenfall;13;13;0
18/07/2019;05:00;95;67;28;Stellenweiser Regenfall;14;14;0
18/07/2019;06:00;306;201;105;Stellenweiser Regenfall;15;15;0
18/07/2019;07:00;1310;825;485;Stellenweiser Regenfall;16;16;0
18/07/2019;08:00;1297;779;518;Stellenweiser Regenfall;18;18;0
18/07/2019;09:00;1146;674;472;Stellenweiser Regenfall;20;20;0
18/07/2019;10:00;904;494;410;Stellenweiser Regenfall;21;21;0
18/07/2019;11:00;1020;537;483;Leicht bewölkt;22;24;0
18/07/2019;12:00;1328;540;788;Leicht bewölkt;24;25;0
18/07/2019;13:00;1327;599;728;Leicht bewölkt;24;25;0
18/07/2019;14:00;1239;614;625;Leicht bewölkt;25;26;0
18/07/2019;15:00;1474;724;750;Leicht bewölkt;25;26;0
18/07/2019;16:00;1536;797;739;Leicht bewölkt;24;25;0
18/07/2019;17:00;1744;840;904;Leicht bewölkt;23;24;0
18/07/2019;18:00;1604;751;853;Leicht bewölkt;22;23;0
18/07/2019;19:00;1182;546;636;Leicht bewölkt;21;21;0
18/07/2019;20:00;924;393;531;Leicht bewölkt;19;19;0
18/07/2019;21:00;684;303;381;Leicht bewölkt;18;18;0
18/07/2019;22:00;572;234;338;Leicht bewölkt;17;17;0
18/07/2019;23:00;363;120;243;Leicht bewölkt;16;16;0
19/07/2019;00:00;160;50;110;Leicht bewölkt;15;15;0
19/07/2019;01:00;89;31;58;Leicht bewölkt;14;15;0
19/07/2019;02:00;30;19;11;Stellenweiser Regenfall;14;14;0
19/07/2019;03:00;16;6;10;Stellenweiser Regenfall;13;14;0
19/07/2019;04:00;14;7;7;Stellenweiser Regenfall;14;14;0
19/07/2019;05:00;73;50;23;Leichter Regenschauer;15;15;0
19/07/2019;06:00;277;174;103;Leichter Regenschauer;15;15;0
19/07/2019;07:00;1141;760;381;Leichter Regenschauer;17;17;0
19/07/2019;08:00;1193;733;460;Stellenweiser Regenfall;19;19;0
19/07/2019;09:00;1184;782;402;Stellenweiser Regenfall;20;20;0
19/07/2019;10:00;1101;628;473;Stellenweiser Regenfall;22;22;0
19/07/2019;11:00;1374;667;707;Stellenweiser Regenfall;23;25;0
19/07/2019;12:00;1377;573;804;Stellenweiser Regenfall;25;26;0
19/07/2019;13:00;1540;657;883;Stellenweiser Regenfall;25;26;0
19/07/2019;14:00;1312;614;698;Leicht bewölkt;26;27;0
19/07/2019;15:00;1342;644;698;Leicht bewölkt;26;27;0
19/07/2019;16:00;1311;645;666;Leicht bewölkt;26;27;0
19/07/2019;17:00;1332;639;693;Leicht bewölkt;25;26;0
19/07/2019;18:00;1307;660;647;Leicht bewölkt;24;26;0
19/07/2019;19:00;1098;589;509;Leicht bewölkt;23;25;0
19/07/2019;20:00;883;480;403;Leicht bewölkt;21;21;0
19/07/2019;21:00;685;294;391;Leicht bewölkt;20;20;0
19/07/2019;22:00;560;219;341;Leicht bewölkt;19;19;0
19/07/2019;23:00;439;143;296;Stellenweiser Regenfall;18;18;0
20/07/2019;00:00;346;111;235;Stellenweiser Regenfall;16;16;0
20/07/2019;01:00;153;65;88;Stellenweiser Regenfall;16;16;0
20/07/2019;02:00;92;34;58;Leicht bewölkt;15;16;0
20/07/2019;03:00;49;25;24;Leicht bewölkt;15;16;0
20/07/2019;04:00;33;15;18;Leicht bewölkt;16;17;0
20/07/2019;05:00;54;31;23;Leicht bewölkt;17;18;0
20/07/2019;06:00;102;63;39;Leicht bewölkt;18;19;0
20/07/2019;07:00;162;90;72;Leicht bewölkt;20;20;0
20/07/2019;08:00;469;247;222;Leicht bewölkt;22;23;0
20/07/2019;09:00;786;510;276;Leicht bewölkt;24;25;0
20/07/2019;10:00;1056;628;428;Leicht bewölkt;25;26;0
20/07/2019;11:00;1106;632;474;Leicht bewölkt;26;27;0
20/07/2019;12:00;1203;608;595;Leicht bewölkt;28;28;0
20/07/2019;13:00;1121;497;624;Leicht bewölkt;28;29;0
20/07/2019;14:00;1072;500;572;Leicht bewölkt;29;29;0
20/07/2019;15:00;1079;486;593;Leicht bewölkt;29;30;0
20/07/2019;16:00;1001;489;512;Leicht bewölkt;28;30;0
20/07/2019;17:00;1031;531;500;Leicht bewölkt;28;30;0
20/07/2019;18:00;1179;668;511;Leicht bewölkt;27;30;0
20/07/2019;19:00;962;543;419;Leicht bewölkt;26;29;0
20/07/2019;20:00;732;420;312;Leicht bewölkt;24;28;0
20/07/2019;21:00;619;281;338;Leicht bewölkt;23;26;0
20/07/2019;22:00;461;191;270;Leicht bewölkt;22;22;0
20/07/2019;23:00;451;136;315;Leicht bewölkt;20;20;0
21/07/2019;00:00;334;90;244;Leicht bewölkt;19;19;0
21/07/2019;01:00;155;47;108;Leicht bewölkt;18;18;0
21/07/2019;02:00;99;29;70;Stellenweiser Regenfall;18;18;0
21/07/2019;03:00;69;17;52;Stellenweiser Regenfall;17;17;0
21/07/2019;04:00;35;21;14;Stellenweiser Regenfall;17;17;0
21/07/2019;05:00;22;8;14;Mäßiger bis starker Regenschauer;18;18;1
21/07/2019;06:00;37;21;16;Mäßiger bis starker Regenschauer;18;18;1
21/07/2019;07:00;61;36;25;Mäßiger bis starker Regenschauer;19;19;0
21/07/2019;08:00;140;63;77;Teilweise mäßiger Regenfall;20;20;0
21/07/2019;09:00;352;224;128;Teilweise mäßiger Regenfall;21;21;0
21/07/2019;10:00;434;254;180;Teilweise mäßiger Regenfall;22;24;0
21/07/2019;11:00;601;304;297;Leichter Regenschauer;23;24;0
21/07/2019;12:00;654;321;333;Leichter Regenschauer;23;25;0
21/07/2019;13:00;738;332;406;Leichter Regenschauer;24;26;0
21/07/2019;14:00;848;411;437;Stellenweiser Regenfall;25;26;0
21/07/2019;15:00;871;435;436;Stellenweiser Regenfall;25;27;0
21/07/2019;16:00;773;352;421;Stellenweiser Regenfall;25;26;0
21/07/2019;17:00;919;490;429;Stellenweiser Regenfall;24;26;0
21/07/2019;18:00;946;516;430;Stellenweiser Regenfall;23;25;0
21/07/2019;19:00;800;416;384;Stellenweiser Regenfall;22;22;0
21/07/2019;20:00;602;283;319;Stellenweiser Regenfall;20;20;0
21/07/2019;21:00;539;200;339;Stellenweiser Regenfall;19;19;0
21/07/2019;22:00;334;104;230;Stellenweiser Regenfall;18;18;0
21/07/2019;23:00;180;70;110;Stellenweiser Regenfall;17;17;0
22/07/2019;00:00;118;75;43;Stellenweiser Regenfall;16;16;0
22/07/2019;01:00;30;13;17;Stellenweiser Regenfall;16;16;0
22/07/2019;02:00;14;5;9;Stellenweiser Regenfall;16;16;0
22/07/2019;03:00;6;2;4;Stellenweiser Regenfall;16;16;0
22/07/2019;04:00;10;9;1;Stellenweiser Regenfall;16;16;0
22/07/2019;05:00;95;64;31;Leicht bewölkt;17;17;0
22/07/2019;06:00;282;194;88;Leicht bewölkt;18;18;0
22/07/2019;07:00;1216;758;458;Leicht bewölkt;20;20;0
22/07/2019;08:00;1359;881;478;Leicht bewölkt;22;22;0
22/07/2019;09:00;1032;636;396;Leicht bewölkt;23;24;0
22/07/2019;10:00;1097;564;533;Leicht bewölkt;25;26;0
22/07/2019;11:00;1166;577;589;Leicht bewölkt;26;28;0
22/07/2019;12:00;1288;528;760;Leicht bewölkt;28;29;0
22/07/2019;13:00;1194;515;679;Leicht bewölkt;28;30;0
22/07/2019;14:00;1175;582;593;Leicht bewölkt;29;30;0
22/07/2019;15:00;1307;647;660;Leicht bewölkt;29;30;0
22/07/2019;16:00;1560;742;818;Leicht bewölkt;28;29;0
22/07/2019;17:00;1643;734;909;Leicht bewölkt;26;28;0
22/07/2019;18:00;1485;679;806;Leicht bewölkt;25;27;0
22/07/2019;19:00;1228;581;647;Leicht bewölkt;24;25;0
22/07/2019;20:00;883;439;444;Leicht bewölkt;22;23;0
22/07/2019;21:00;668;239;429;Leicht bewölkt;21;21;0
22/07/2019;22:00;466;187;279;Leicht bewölkt;20;20;0
22/07/2019;23:00;239;74;165;Leicht bewölkt;19;19;0
23/07/2019;00:00;120;44;76;Leicht bewölkt;18;18;0
23/07/2019;01:00;62;27;35;Leicht bewölkt;18;18;0
23/07/2019;02:00;18;8;10;Leicht bewölkt;18;18;0
23/07/2019;03:00;17;8;9;Leicht bewölkt;17;17;0
23/07/2019;04:00;17;12;5;Leicht bewölkt;18;18;0
23/07/2019;05:00;92;63;29;Leicht bewölkt;19;19;0
23/07/2019;06:00;302;187;115;Leicht bewölkt;20;20;0
23/07/2019;07:00;1219;821;398;Leicht bewölkt;22;22;0
23/07/2019;08:00;1565;927;638;Leicht bewölkt;23;25;0
23/07/2019;09:00;1121;665;456;Leicht bewölkt;25;27;0
23/07/2019;10:00;1124;583;541;Leicht bewölkt;26;28;0
23/07/2019;11:00;1071;544;527;Leicht bewölkt;27;29;0
23/07/2019;12:00;1339;532;807;Leicht bewölkt;28;30;0
23/07/2019;13:00;1382;605;777;Leicht bewölkt;28;30;0
23/07/2019;14:00;1268;576;692;Leicht bewölkt;29;30;0
23/07/2019;15:00;1299;580;719;Leicht bewölkt;29;31;0
23/07/2019;16:00;1439;677;762;Leicht bewölkt;28;30;0
23/07/2019;17:00;1638;825;813;Leicht bewölkt;27;29;0
23/07/2019;18:00;1685;923;762;Leicht bewölkt;26;28;0
23/07/2019;19:00;1372;721;651;Leicht bewölkt;24;26;0
23/07/2019;20:00;914;407;507;Leicht bewölkt;23;24;0
23/07/2019;21:00;806;329;477;Leicht bewölkt;22;22;0
23/07/2019;22:00;593;165;428;Leicht bewölkt;21;21;0
23/07/2019;23:00;325;89;236;Leicht bewölkt;20;20;0
24/07/2019;00:00;162;57;105;Leicht bewölkt;19;19;0
24/07/2019;01:00;62;25;37;Leicht bewölkt;19;19;0
24/07/2019;02:00;41;25;16;Leicht bewölkt;19;19;0
24/07/2019;03:00;18;9;9;Leicht bewölkt;18;18;0
24/07/2019;04:00;18;11;7;Leicht bewölkt;19;19;0
24/07/2019;05:00;95;60;35;Leicht bewölkt;20;20;0
24/07/2019;06:00;318;206;112;Leicht bewölkt;21;21;0
24/07/2019;07:00;1242;781;461;Leicht bewölkt;23;24;0
24/07/2019;08:00;1499;883;616;Leicht bewölkt;25;27;0
24/07/2019;09:00;1048;608;440;Leicht bewölkt;27;29;0
24/07/2019;10:00;1028;572;456;Leicht bewölkt;28;30;0
24/07/2019;11:00;1087;571;516;Leicht bewölkt;30;32;0
24/07/2019;12:00;1339;546;793;Leicht bewölkt;31;34;0
24/07/2019;13:00;1341;593;748;Leicht bewölkt;32;35;0
24/07/2019;14:00;1149;534;615;Leicht bewölkt;33;35;0
24/07/2019;15:00;1160;573;587;Leicht bewölkt;33;36;0
24/07/2019;16:00;1350;605;745;Leicht bewölkt;33;36;0
24/07/2019;17:00;1443;714;729;Leicht bewölkt;33;36;0
24/07/2019;18:00;1449;704;745;Leicht bewölkt;32;35;0
24/07/2019;19:00;1197;623;574;Leicht bewölkt;31;34;0
24/07/2019;20:00;972;480;492;Leicht bewölkt;30;33;0
24/07/2019;21:00;724;319;405;Leicht bewölkt;29;33;0
24/07/2019;22:00;517;215;302;Leicht bewölkt;27;30;0
24/07/2019;23:00;385;110;275;Leicht bewölkt;25;27;0
25/07/2019;00:00;199;56;143;Leicht bewölkt;23;24;0
25/07/2019;01:00;87;25;62;Leicht bewölkt;22;22;0
25/07/2019;02:00;40;16;24;Leicht bewölkt;21;21;0
25/07/2019;03:00;16;6;10;Leicht bewölkt;20;20;0
25/07/2019;04:00;37;23;14;Leicht bewölkt;20;20;0
25/07/2019;05:00;96;67;29;Leicht bewölkt;21;21;0
25/07/2019;06:00;275;173;102;Leicht bewölkt;22;22;0
25/07/2019;07:00;1106;699;407;Leicht bewölkt;23;25;0
25/07/2019;08:00;1470;854;616;Leicht bewölkt;25;27;0
25/07/2019;09:00;1026;601;425;Leicht bewölkt;27;29;0
25/07/2019;10:00;1026;546;480;Leicht bewölkt;28;30;0
25/07/2019;11:00;1000;481;519;Leicht bewölkt;29;31;0
25/07/2019;12:00;1289;511;778;Leicht bewölkt;31;33;0
25/07/2019;13:00;847;434;413;Leicht bewölkt;31;33;0
25/07/2019;14:00;0;0;0;Leicht bewölkt;31;34;0
25/07/2019;15:00;0;0;0;Leicht bewölkt;31;34;0
25/07/2019;16:00;0;0;0;Leicht bewölkt;31;34;0
25/07/2019;17:00;0;0;0;Leicht bewölkt;30;33;0
25/07/2019;18:00;0;0;0;Leicht bewölkt;29;32;0
25/07/2019;19:00;0;0;0;Leicht bewölkt;28;31;0
25/07/2019;20:00;0;0;0;Leicht bewölkt;27;30;0
25/07/2019;21:00;0;0;0;Leicht bewölkt;26;28;0
25/07/2019;22:00;0;0;0;Leicht bewölkt;24;26;0
25/07/2019;23:00;0;0;0;Leicht bewölkt;23;24;0
26/07/2019;00:00;0;0;0;Leicht bewölkt;21;21;0
26/07/2019;01:00;0;0;0;Leicht bewölkt;20;20;0
26/07/2019;02:00;0;0;0;Stellenweiser Regenfall;20;20;0
26/07/2019;03:00;0;0;0;Stellenweiser Regenfall;19;19;0
26/07/2019;04:00;0;0;0;Stellenweiser Regenfall;19;19;0
26/07/2019;05:00;0;0;0;Teilweise mäßiger Regenfall;20;20;0
26/07/2019;06:00;0;0;0;Teilweise mäßiger Regenfall;21;21;0
26/07/2019;07:00;0;0;0;Teilweise mäßiger Regenfall;22;24;0
26/07/2019;08:00;0;0;0;Stellenweiser Regenfall;23;26;0
26/07/2019;09:00;0;0;0;Stellenweiser Regenfall;25;27;0
26/07/2019;10:00;0;0;0;Stellenweiser Regenfall;26;28;0
26/07/2019;11:00;0;0;0;Nieselregen mit Gewitter;27;29;0
26/07/2019;12:00;0;0;0;Nieselregen mit Gewitter;28;30;0
26/07/2019;13:00;0;0;0;Nieselregen mit Gewitter;28;30;0
26/07/2019;14:00;0;0;0;Nieselregen mit Gewitter;28;30;0
26/07/2019;15:00;0;0;0;Nieselregen mit Gewitter;27;29;0
26/07/2019;16:00;0;0;0;Nieselregen mit Gewitter;26;28;0
26/07/2019;17:00;0;0;0;Leichter Regenschauer;25;27;0
26/07/2019;18:00;0;0;0;Leichter Regenschauer;24;26;0
26/07/2019;19:00;0;0;0;Leichter Regenschauer;22;24;0
26/07/2019;20:00;0;0;0;Leicht bewölkt;21;21;0
26/07/2019;21:00;0;0;0;Leicht bewölkt;20;20;0
26/07/2019;22:00;0;0;0;Leicht bewölkt;19;19;0
26/07/2019;23:00;0;0;0;Leicht bewölkt;18;18;0
27/07/2019;00:00;0;0;0;Leicht bewölkt;17;17;0
27/07/2019;01:00;0;0;0;Leicht bewölkt;17;17;0
27/07/2019;02:00;0;0;0;Leicht bewölkt;17;17;0
27/07/2019;03:00;0;0;0;Leicht bewölkt;17;17;0
27/07/2019;04:00;0;0;0;Leicht bewölkt;17;17;0
27/07/2019;05:00;0;0;0;Leichter Regenschauer;18;18;0
27/07/2019;06:00;0;0;0;Leichter Regenschauer;18;18;0
27/07/2019;07:00;0;0;0;Leichter Regenschauer;20;20;0
27/07/2019;08:00;0;0;0;Stellenweiser Regenfall;21;21;0
27/07/2019;09:00;0;0;0;Stellenweiser Regenfall;22;24;0
27/07/2019;10:00;0;0;0;Stellenweiser Regenfall;23;24;0
27/07/2019;11:00;0;0;0;Stellenweiser Regenfall;23;25;0
27/07/2019;12:00;0;0;0;Stellenweiser Regenfall;24;26;0
27/07/2019;13:00;0;0;0;Stellenweiser Regenfall;24;25;0
27/07/2019;14:00;0;0;0;Leichter Regenschauer;24;25;0
27/07/2019;15:00;0;0;0;Leichter Regenschauer;24;25;0
27/07/2019;16:00;0;0;0;Leichter Regenschauer;23;24;0
27/07/2019;17:00;0;0;0;Mäßiger bis starker Regenschauer;22;22;1
27/07/2019;18:00;0;0;0;Mäßiger bis starker Regenschauer;21;21;1
27/07/2019;19:00;0;0;0;Mäßiger bis starker Regenschauer;20;20;0
27/07/2019;20:00;0;0;0;Mäßiger bis starker Regenschauer;19;19;0
27/07/2019;21:00;0;0;0;Mäßiger bis starker Regenschauer;17;17;1
27/07/2019;22:00;0;0;0;Mäßiger bis starker Regenschauer;17;17;0
27/07/2019;23:00;0;0;0;Leichter Regenschauer;16;16;0
28/07/2019;00:00;0;0;0;Leichter Regenschauer;16;16;0
28/07/2019;01:00;0;0;0;Leichter Regenschauer;16;16;0
28/07/2019;02:00;0;0;0;Leichter Regenschauer;16;16;0
28/07/2019;03:00;0;0;0;Leichter Regenschauer;16;16;0
28/07/2019;04:00;0;0;0;Leichter Regenschauer;16;16;0
28/07/2019;05:00;0;0;0;Leichter Regenschauer;17;17;0
28/07/2019;06:00;0;0;0;Leichter Regenschauer;17;17;0
28/07/2019;07:00;0;0;0;Leichter Regenschauer;17;17;0
28/07/2019;08:00;0;0;0;Leichter Nebel;17;17;0
28/07/2019;09:00;0;0;0;Leichter Nebel;17;17;0
28/07/2019;10:00;0;0;0;Leichter Nebel;17;17;0
28/07/2019;11:00;0;0;0;Mäßiger Regenfall;17;17;0
28/07/2019;12:00;0;0;0;Mäßiger Regenfall;17;17;1
28/07/2019;13:00;0;0;0;Mäßiger Regenfall;17;17;0
28/07/2019;14:00;0;0;0;Mäßiger Regenfall;17;17;0
28/07/2019;15:00;0;0;0;Mäßiger Regenfall;17;17;0
28/07/2019;16:00;0;0;0;Mäßiger Regenfall;17;16;0
28/07/2019;17:00;0;0;0;Leichter Regenfall;16;16;0
28/07/2019;18:00;0;0;0;Leichter Regenfall;16;15;0
28/07/2019;19:00;0;0;0;Leichter Regenfall;15;14;0
28/07/2019;20:00;0;0;0;Bedeckt;15;14;0
28/07/2019;21:00;0;0;0;Bedeckt;15;14;0
28/07/2019;22:00;0;0;0;Bedeckt;15;14;0
28/07/2019;23:00;0;0;0;Nieselregen;15;14;0
29/07/2019;00:00;0;0;0;Nieselregen;15;14;0
29/07/2019;01:00;0;0;0;Nieselregen;15;15;0
29/07/2019;02:00;0;0;0;Bewölkt;15;15;0
29/07/2019;03:00;0;0;0;Bewölkt;15;15;0
29/07/2019;04:00;0;0;0;Bewölkt;15;15;0
29/07/2019;05:00;0;0;0;Nieselregen;15;15;0
29/07/2019;06:00;0;0;0;Nieselregen;16;16;0
29/07/2019;07:00;0;0;0;Nieselregen;17;17;0
29/07/2019;08:00;0;0;0;Stellenweiser Nieselregen;18;18;0
29/07/2019;09:00;0;0;0;Stellenweiser Nieselregen;19;19;0
29/07/2019;10:00;0;0;0;Stellenweiser Nieselregen;20;20;0
29/07/2019;11:00;0;0;0;Leicht bewölkt;20;20;0
29/07/2019;12:00;0;0;0;Leicht bewölkt;21;21;0
29/07/2019;13:00;0;0;0;Leicht bewölkt;22;22;0
29/07/2019;14:00;0;0;0;Leicht bewölkt;22;24;0
29/07/2019;15:00;0;0;0;Leicht bewölkt;23;25;0
29/07/2019;16:00;0;0;0;Leicht bewölkt;22;24;0
29/07/2019;17:00;0;0;0;Leicht bewölkt;22;22;0
29/07/2019;18:00;0;0;0;Leicht bewölkt;22;22;0
29/07/2019;19:00;0;0;0;Leicht bewölkt;20;20;0
29/07/2019;20:00;0;0;0;Bewölkt;19;19;0
29/07/2019;21:00;0;0;0;Bewölkt;18;18;0
29/07/2019;22:00;0;0;0;Bewölkt;17;17;0
29/07/2019;23:00;0;0;0;Bewölkt;16;16;0
30/07/2019;00:00;0;0;0;Bewölkt;16;16;0
30/07/2019;01:00;0;0;0;Bewölkt;15;15;0
30/07/2019;02:00;0;0;0;Bewölkt;15;15;0
30/07/2019;03:00;0;0;0;Bewölkt;14;14;0
30/07/2019;04:00;0;0;0;Bewölkt;15;15;0
30/07/2019;05:00;0;0;0;Leicht bewölkt;16;16;0
30/07/2019;06:00;0;0;0;Leicht bewölkt;17;17;0
30/07/2019;07:00;0;0;0;Leicht bewölkt;18;18;0
30/07/2019;08:00;0;0;0;Leicht bewölkt;20;20;0
30/07/2019;09:00;260;138;122;Leicht bewölkt;22;22;0
30/07/2019;10:00;973;538;435;Leicht bewölkt;23;24;0
30/07/2019;11:00;1124;547;577;Leicht bewölkt;24;25;0
30/07/2019;12:00;1099;509;590;Leicht bewölkt;25;26;0
30/07/2019;13:00;1088;499;589;Leicht bewölkt;26;27;0
30/07/2019;14:00;1077;533;544;Leicht bewölkt;26;27;0
30/07/2019;15:00;1184;564;620;Leicht bewölkt;26;27;0
30/07/2019;16:00;1374;668;706;Leicht bewölkt;26;27;0
30/07/2019;17:00;1501;726;775;Stellenweiser Regenfall;25;27;0
30/07/2019;18:00;1372;654;718;Stellenweiser Regenfall;24;27;0
30/07/2019;19:00;1095;529;566;Stellenweiser Regenfall;23;26;0
30/07/2019;20:00;823;352;471;Stellenweiser Regenfall;22;22;0
30/07/2019;21:00;679;291;388;Stellenweiser Regenfall;21;21;0
30/07/2019;22:00;441;195;246;Stellenweiser Regenfall;20;20;0
30/07/2019;23:00;252;73;179;Stellenweiser Regenfall;18;19;0
31/07/2019;00:00;92;41;51;Stellenweiser Regenfall;17;17;1
31/07/2019;01:00;80;30;50;Stellenweiser Regenfall;16;17;0
31/07/2019;02:00;32;11;21;Mäßiger bis starker Regenschauer;15;16;0
31/07/2019;03:00;8;5;3;Mäßiger bis starker Regenschauer;15;15;0
31/07/2019;04:00;8;6;2;Mäßiger bis starker Regenschauer;15;15;0
31/07/2019;05:00;50;33;17;Leichter Regenschauer;15;15;0
31/07/2019;06:00;212;134;78;Leichter Regenschauer;15;16;0
31/07/2019;07:00;537;333;204;Leichter Regenschauer;16;16;0
31/07/2019;08:00;846;504;342;Leichter Nebel;16;16;0
31/07/2019;09:00;760;491;269;Leichter Nebel;17;17;0
31/07/2019;10:00;779;460;319;Leichter Nebel;17;17;0
31/07/2019;11:00;879;446;433;Mäßiger Regenfall;17;17;0
31/07/2019;12:00;959;456;503;Mäßiger Regenfall;17;17;0
31/07/2019;13:00;883;425;458;Mäßiger Regenfall;18;18;0
31/07/2019;14:00;964;482;482;Leichter Regenfall;19;19;0
31/07/2019;15:00;1044;521;523;Leichter Regenfall;20;20;0
31/07/2019;16:00;1368;703;665;Leichter Regenfall;20;20;0
31/07/2019;17:00;1392;695;697;Leicht bewölkt;20;20;0
31/07/2019;18:00;1384;770;614;Leicht bewölkt;20;20;0
31/07/2019;19:00;1241;810;431;Leicht bewölkt;19;19;0
31/07/2019;20:00;905;542;363;Leicht bewölkt;17;17;0
31/07/2019;21:00;677;285;392;Leicht bewölkt;16;16;0
31/07/2019;22:00;534;170;364;Leicht bewölkt;15;15;0
31/07/2019;23:00;483;77;406;Leicht bewölkt;14;14;0
01/08/2019;00:00;416;31;385;Leicht bewölkt;13;13;0
01/08/2019;01:00;303;15;288;Leicht bewölkt;13;13;0
01/08/2019;02:00;76;19;57;Leicht bewölkt;12;12;0
01/08/2019;03:00;37;12;25;Leicht bewölkt;12;12;0
01/08/2019;04:00;23;8;15;Leicht bewölkt;13;13;0
01/08/2019;05:00;69;39;30;Leicht bewölkt;14;14;0
01/08/2019;06:00;192;99;93;Leicht bewölkt;14;14;0
01/08/2019;07:00;531;291;240;Leicht bewölkt;16;16;0
01/08/2019;08:00;933;520;413;Leicht bewölkt;18;18;0
01/08/2019;09:00;916;559;357;Leicht bewölkt;20;20;0
01/08/2019;10:00;971;527;444;Leicht bewölkt;22;22;0
01/08/2019;11:00;1109;547;562;Leicht bewölkt;23;24;0
01/08/2019;12:00;1150;566;584;Leicht bewölkt;24;26;0
01/08/2019;13:00;1118;489;629;Leicht bewölkt;24;26;0
01/08/2019;14:00;1145;593;552;Leicht bewölkt;24;26;0
01/08/2019;15:00;1217;593;624;Leicht bewölkt;24;26;0
01/08/2019;16:00;1319;663;656;Leicht bewölkt;23;24;0
01/08/2019;17:00;1514;784;730;Leicht bewölkt;22;23;0
01/08/2019;18:00;1465;804;661;Leicht bewölkt;21;21;0
01/08/2019;19:00;1181;681;500;Leicht bewölkt;20;20;0
01/08/2019;20:00;917;500;417;Leicht bewölkt;19;19;0
01/08/2019;21:00;631;296;335;Leicht bewölkt;17;17;0
01/08/2019;22:00;502;187;315;Leicht bewölkt;17;17;0
01/08/2019;23:00;367;74;293;Leicht bewölkt;16;16;0
02/08/2019;00:00;299;41;258;Leicht bewölkt;16;16;0
02/08/2019;01:00;216;30;186;Leicht bewölkt;15;15;0
02/08/2019;02:00;42;15;27;Stellenweiser Regenfall;15;15;0
02/08/2019;03:00;31;15;16;Stellenweiser Regenfall;14;15;0
02/08/2019;04:00;15;5;10;Stellenweiser Regenfall;15;15;0
02/08/2019;05:00;60;42;18;Leichter Regenschauer;15;15;0
02/08/2019;06:00;191;115;76;Leichter Regenschauer;16;16;0
02/08/2019;07:00;544;322;222;Leichter Regenschauer;16;16;0
02/08/2019;08:00;809;503;306;Leichter Regenschauer;17;17;0
02/08/2019;09:00;848;552;296;Leichter Regenschauer;17;17;0
02/08/2019;10:00;835;502;333;Leichter Regenschauer;18;18;0
02/08/2019;11:00;1009;570;439;Leichter Regenschauer;19;19;0
02/08/2019;12:00;745;343;402;Leichter Regenschauer;20;20;1
02/08/2019;13:00;861;398;463;Leichter Regenschauer;20;20;0
02/08/2019;14:00;914;485;429;Mäßiger bis starker Regenschauer;21;21;1
02/08/2019;15:00;948;488;460;Mäßiger bis starker Regenschauer;21;21;1
02/08/2019;16:00;1064;525;539;Mäßiger bis starker Regenschauer;20;20;0
02/08/2019;17:00;1035;517;518;Mäßiger bis starker Regenschauer;20;20;1
02/08/2019;18:00;1130;612;518;Mäßiger bis starker Regenschauer;19;19;1
02/08/2019;19:00;931;502;429;Mäßiger bis starker Regenschauer;18;18;0
02/08/2019;20:00;721;443;278;Mäßiger bis starker Regenschauer;16;16;0
02/08/2019;21:00;526;242;284;Mäßiger bis starker Regenschauer;15;15;0
02/08/2019;22:00;479;145;334;Mäßiger bis starker Regenschauer;15;15;0
02/08/2019;23:00;387;97;290;Stellenweiser Regenfall;14;14;0
03/08/2019;00:00;359;72;287;Stellenweiser Regenfall;14;14;0
03/08/2019;01:00;279;39;240;Stellenweiser Regenfall;13;13;0
03/08/2019;02:00;116;28;88;Leicht bewölkt;13;13;0
03/08/2019;03:00;61;15;46;Leicht bewölkt;12;12;0
03/08/2019;04:00;25;14;11;Leicht bewölkt;13;13;0
03/08/2019;05:00;28;22;6;Leichter Regenschauer;13;14;0
03/08/2019;06:00;78;58;20;Leichter Regenschauer;14;14;0
03/08/2019;07:00;117;64;53;Leichter Regenschauer;16;16;0
03/08/2019;08:00;309;182;127;Leicht bewölkt;17;17;0
03/08/2019;09:00;701;437;264;Leicht bewölkt;19;19;0
03/08/2019;10:00;853;487;366;Leicht bewölkt;20;20;0
03/08/2019;11:00;1106;625;481;Teilweise mäßiger Regenfall;21;21;0
03/08/2019;12:00;1046;559;487;Teilweise mäßiger Regenfall;22;23;0
03/08/2019;13:00;1001;484;517;Teilweise mäßiger Regenfall;23;24;0
03/08/2019;14:00;950;463;487;Leicht bewölkt;23;24;0
03/08/2019;15:00;1013;468;545;Leicht bewölkt;24;25;0
03/08/2019;16:00;1000;468;532;Leicht bewölkt;23;25;0
03/08/2019;17:00;1018;462;556;Stellenweiser Regenfall;22;25;0
03/08/2019;18:00;953;528;425;Stellenweiser Regenfall;22;22;0
03/08/2019;19:00;846;461;385;Stellenweiser Regenfall;21;21;0
03/08/2019;20:00;672;370;302;Leicht bewölkt;19;19;0
03/08/2019;21:00;489;232;257;Leicht bewölkt;18;18;0
03/08/2019;22:00;392;185;207;Leicht bewölkt;17;17;0
03/08/2019;23:00;331;105;226;Leicht bewölkt;15;15;0
04/08/2019;00:00;319;91;228;Leicht bewölkt;14;14;0
04/08/2019;01:00;229;54;175;Leicht bewölkt;14;14;0
04/08/2019;02:00;143;53;90;Leicht bewölkt;13;13;0
04/08/2019;03:00;51;21;30;Leicht bewölkt;12;12;0
04/08/2019;04:00;43;20;23;Leicht bewölkt;13;13;0
04/08/2019;05:00;33;18;15;Leicht bewölkt;14;14;0
04/08/2019;06:00;48;33;15;Leicht bewölkt;14;14;0
04/08/2019;07:00;89;56;33;Leicht bewölkt;16;16;0
04/08/2019;08:00;153;80;73;Leicht bewölkt;18;18;0
04/08/2019;09:00;386;206;180;Leicht bewölkt;20;20;0
04/08/2019;10:00;555;243;312;Leicht bewölkt;21;21;0
04/08/2019;11:00;733;344;389;Leicht bewölkt;23;24;0
04/08/2019;12:00;748;339;409;Leicht bewölkt;24;26;0
04/08/2019;13:00;798;338;460;Leicht bewölkt;24;26;0
04/08/2019;14:00;815;357;458;Leicht bewölkt;25;26;0
04/08/2019;15:00;807;372;435;Leicht bewölkt;25;26;0
04/08/2019;16:00;778;402;376;Leicht bewölkt;24;26;0
04/08/2019;17:00;846;448;398;Leicht bewölkt;23;25;0
04/08/2019;18:00;912;523;389;Leicht bewölkt;22;25;0
04/08/2019;19:00;691;368;323;Leicht bewölkt;21;21;0
04/08/2019;20:00;575;282;293;Leicht bewölkt;19;19;0
04/08/2019;21:00;374;171;203;Leicht bewölkt;18;18;0
04/08/2019;22:00;236;104;132;Leicht bewölkt;17;17;0
04/08/2019;23:00;101;39;62;Leicht bewölkt;16;16;0
05/08/2019;00:00;61;33;28;Leicht bewölkt;15;16;0
05/08/2019;01:00;38;17;21;Leicht bewölkt;15;16;0
05/08/2019;02:00;6;3;3;Leicht bewölkt;15;15;0
05/08/2019;03:00;5;2;3;Leicht bewölkt;15;15;0
05/08/2019;04:00;14;10;4;Leicht bewölkt;15;15;0
05/08/2019;05:00;72;51;21;Leicht bewölkt;15;16;0
05/08/2019;06:00;247;177;70;Leicht bewölkt;16;16;0
05/08/2019;07:00;603;375;228;Leicht bewölkt;18;18;0
05/08/2019;08:00;767;483;284;Leicht bewölkt;19;19;0
05/08/2019;09:00;756;480;276;Leicht bewölkt;21;21;0
05/08/2019;10:00;839;493;346;Leicht bewölkt;23;24;0
05/08/2019;11:00;883;472;411;Leicht bewölkt;24;25;0
05/08/2019;12:00;1019;512;507;Leicht bewölkt;26;27;0
05/08/2019;13:00;930;452;478;Leicht bewölkt;26;27;0
05/08/2019;14:00;1048;522;526;Leicht bewölkt;27;28;0
05/08/2019;15:00;1077;483;594;Leicht bewölkt;28;28;0
05/08/2019;16:00;1157;533;624;Leicht bewölkt;27;28;0
05/08/2019;17:00;1315;602;713;Leicht bewölkt;27;28;0
05/08/2019;18:00;1177;523;654;Leicht bewölkt;27;28;0
05/08/2019;19:00;903;398;505;Leicht bewölkt;26;27;0
05/08/2019;20:00;687;308;379;Leicht bewölkt;25;27;0
05/08/2019;21:00;450;189;261;Leicht bewölkt;24;26;0
05/08/2019;22:00;259;82;177;Leicht bewölkt;22;24;0
05/08/2019;23:00;229;80;149;Leichter Regenschauer;20;20;0
06/08/2019;00:00;89;35;54;Leichter Regenschauer;18;18;1
06/08/2019;01:00;29;12;17;Leichter Regenschauer;17;17;0
06/08/2019;02:00;15;7;8;Mäßiger bis starker Regenschauer;16;16;0
06/08/2019;03:00;10;0;10;Mäßiger bis starker Regenschauer;16;16;0
06/08/2019;04:00;14;12;2;Mäßiger bis starker Regenschauer;16;16;0
06/08/2019;05:00;45;28;17;Mäßiger bis starker Regenschauer;16;16;1
06/08/2019;06:00;114;68;46;Mäßiger bis starker Regenschauer;17;17;1
06/08/2019;07:00;258;154;104;Mäßiger bis starker Regenschauer;18;18;0
06/08/2019;08:00;513;314;199;Mäßiger bis starker Regenschauer;19;19;0
06/08/2019;09:00;608;369;239;Mäßiger bis starker Regenschauer;21;21;0
06/08/2019;10:00;701;441;260;Mäßiger bis starker Regenschauer;22;24;0
06/08/2019;11:00;754;404;350;Leichter Regenschauer;24;25;0
06/08/2019;12:00;504;169;335;Leichter Regenschauer;25;27;0
06/08/2019;13:00;513;258;255;Leichter Regenschauer;26;27;0
06/08/2019;14:00;518;247;271;Nieselregen mit Gewitter;27;28;0
06/08/2019;15:00;688;408;280;Nieselregen mit Gewitter;27;29;0
06/08/2019;16:00;866;431;435;Nieselregen mit Gewitter;27;28;0
06/08/2019;17:00;858;361;497;Nieselregen mit Gewitter;26;28;0
06/08/2019;18:00;703;287;416;Nieselregen mit Gewitter;25;28;0
06/08/2019;19:00;602;290;312;Nieselregen mit Gewitter;24;27;0
06/08/2019;20:00;387;175;212;Nieselregen mit Gewitter;23;26;1
06/08/2019;21:00;282;139;143;Nieselregen mit Gewitter;22;22;2
06/08/2019;22:00;206;75;131;Nieselregen mit Gewitter;21;21;1
06/08/2019;23:00;146;41;105;Teilweise starker Regenfall;20;20;2
07/08/2019;00:00;83;35;48;Teilweise starker Regenfall;19;19;3
07/08/2019;01:00;27;11;16;Teilweise starker Regenfall;18;18;2
07/08/2019;02:00;14;8;6;Teilweise starker Regenfall;17;17;0
07/08/2019;03:00;3;1;2;Teilweise starker Regenfall;16;16;1
07/08/2019;04:00;11;9;2;Teilweise starker Regenfall;17;17;0
07/08/2019;05:00;60;43;17;Leicht bewölkt;17;17;0
07/08/2019;06:00;198;127;71;Leicht bewölkt;17;17;0
07/08/2019;07:00;480;294;186;Leicht bewölkt;18;18;0
07/08/2019;08:00;660;402;258;Bewölkt;18;18;0
07/08/2019;09:00;711;454;257;Bewölkt;19;19;0
07/08/2019;10:00;511;309;202;Bewölkt;19;19;0
07/08/2019;11:00;449;241;208;Stellenweiser Regenfall;20;20;0
07/08/2019;12:00;452;218;234;Stellenweiser Regenfall;20;20;0
07/08/2019;13:00;433;218;215;Stellenweiser Regenfall;20;20;0
07/08/2019;14:00;492;226;266;Bewölkt;19;19;0
07/08/2019;15:00;601;307;294;Bewölkt;18;18;0
07/08/2019;16:00;749;376;373;Bewölkt;18;18;0
07/08/2019;17:00;937;472;465;Mäßiger Regenfall;17;17;0
07/08/2019;18:00;657;264;393;Mäßiger Regenfall;16;16;0
07/08/2019;19:00;515;216;299;Mäßiger Regenfall;16;16;0
07/08/2019;20:00;341;136;205;Bewölkt;15;15;0
07/08/2019;21:00;250;105;145;Bewölkt;14;14;0
07/08/2019;22:00;192;61;131;Bewölkt;14;14;0
07/08/2019;23:00;107;39;68;Leichter Regenschauer;14;14;0
08/08/2019;00:00;67;18;49;Leichter Regenschauer;14;14;0
08/08/2019;01:00;42;9;33;Leichter Regenschauer;14;14;0
08/08/2019;02:00;23;14;9;Leichter Regenschauer;14;14;0
08/08/2019;03:00;8;3;5;Leichter Regenschauer;14;14;0
08/08/2019;04:00;13;8;5;Leichter Regenschauer;14;15;0
08/08/2019;05:00;57;39;18;Leicht bewölkt;15;15;0
08/08/2019;06:00;210;146;64;Leicht bewölkt;15;16;0
08/08/2019;07:00;489;287;202;Leicht bewölkt;17;17;0
08/08/2019;08:00;667;414;253;Leicht bewölkt;18;19;0
08/08/2019;09:00;738;471;267;Leicht bewölkt;20;20;0
08/08/2019;10:00;793;434;359;Leicht bewölkt;21;21;0
08/08/2019;11:00;994;579;415;Leicht bewölkt;23;24;0
08/08/2019;12:00;1021;477;544;Leicht bewölkt;24;26;0
08/08/2019;13:00;954;474;480;Leicht bewölkt;25;26;0
08/08/2019;14:00;991;475;516;Leicht bewölkt;25;26;0
08/08/2019;15:00;1180;583;597;Leicht bewölkt;26;27;0
08/08/2019;16:00;1207;565;642;Leicht bewölkt;25;27;0
08/08/2019;17:00;1465;694;771;Leicht bewölkt;25;27;0
08/08/2019;18:00;1423;692;731;Leicht bewölkt;24;27;0
08/08/2019;19:00;1174;647;527;Leicht bewölkt;23;26;0
08/08/2019;20:00;779;419;360;Leicht bewölkt;22;22;0
08/08/2019;21:00;663;261;402;Leicht bewölkt;21;21;0
08/08/2019;22:00;535;171;364;Leicht bewölkt;19;19;0
08/08/2019;23:00;380;71;309;Leicht bewölkt;18;18;0
09/08/2019;00:00;240;38;202;Leicht bewölkt;17;17;0
09/08/2019;01:00;101;9;92;Leicht bewölkt;16;16;0
09/08/2019;02:00;41;16;25;Leicht bewölkt;16;16;0
09/08/2019;03:00;22;6;16;Leicht bewölkt;15;16;0
09/08/2019;04:00;8;4;4;Leicht bewölkt;16;16;0
09/08/2019;05:00;66;45;21;Leicht bewölkt;17;17;0
09/08/2019;06:00;227;146;81;Leicht bewölkt;17;18;0
09/08/2019;07:00;502;315;187;Leicht bewölkt;19;20;0
09/08/2019;08:00;715;449;266;Leicht bewölkt;22;22;0
09/08/2019;09:00;809;522;287;Leicht bewölkt;24;24;0
09/08/2019;10:00;924;542;382;Leicht bewölkt;25;26;0
09/08/2019;11:00;1056;561;495;Leicht bewölkt;27;28;0
09/08/2019;12:00;1187;519;668;Leicht bewölkt;29;29;0
09/08/2019;13:00;1000;431;569;Leicht bewölkt;29;30;0
09/08/2019;14:00;1042;482;560;Leicht bewölkt;30;31;0
09/08/2019;15:00;1045;496;549;Leicht bewölkt;31;32;0
09/08/2019;16:00;1104;549;555;Leicht bewölkt;30;31;0
09/08/2019;17:00;1189;669;520;Leicht bewölkt;29;31;0
09/08/2019;18:00;1251;662;589;Leicht bewölkt;29;31;0
09/08/2019;19:00;1180;691;489;Leicht bewölkt;28;30;0
09/08/2019;20:00;856;546;310;Leicht bewölkt;27;29;0
09/08/2019;21:00;703;383;320;Leicht bewölkt;26;29;0
09/08/2019;22:00;498;215;283;Leicht bewölkt;24;26;0
09/08/2019;23:00;626;96;530;Leicht bewölkt;23;24;0
10/08/2019;00:00;438;64;374;Leicht bewölkt;21;21;0
10/08/2019;01:00;171;25;146;Leicht bewölkt;21;21;0
10/08/2019;02:00;106;25;81;Leicht bewölkt;20;20;0
10/08/2019;03:00;60;19;41;Leicht bewölkt;20;20;0
10/08/2019;04:00;17;8;9;Leicht bewölkt;20;20;0
10/08/2019;05:00;31;17;14;Mäßiger bis starker Regenschauer;20;20;0
10/08/2019;06:00;33;24;9;Mäßiger bis starker Regenschauer;20;20;1
10/08/2019;07:00;39;28;11;Mäßiger bis starker Regenschauer;20;20;0
10/08/2019;08:00;105;68;37;Mäßiger bis starker Regenschauer;19;19;0
10/08/2019;09:00;249;154;95;Mäßiger bis starker Regenschauer;19;19;1
10/08/2019;10:00;348;201;147;Mäßiger bis starker Regenschauer;19;19;0
10/08/2019;11:00;384;233;151;Mäßiger Regenfall;19;19;0
10/08/2019;12:00;474;291;183;Mäßiger Regenfall;19;19;0
10/08/2019;13:00;557;269;288;Mäßiger Regenfall;20;20;0
10/08/2019;14:00;777;440;337;Stellenweiser leichter Regenfall;20;20;0
10/08/2019;15:00;705;393;312;Stellenweiser leichter Regenfall;21;21;0
10/08/2019;16:00;777;387;390;Stellenweiser leichter Regenfall;20;20;0
10/08/2019;17:00;797;383;414;Leicht bewölkt;20;20;0
10/08/2019;18:00;851;421;430;Leicht bewölkt;20;20;0
10/08/2019;19:00;743;399;344;Leicht bewölkt;19;19;0
10/08/2019;20:00;703;319;384;Stellenweiser Regenfall;19;19;0
10/08/2019;21:00;650;277;373;Stellenweiser Regenfall;18;18;0
10/08/2019;22:00;248;104;144;Stellenweiser Regenfall;17;17;0
10/08/2019;23:00;816;430;386;Leicht bewölkt;17;17;0
11/08/2019;00:00;511;221;290;Leicht bewölkt;16;16;0
11/08/2019;01:00;288;105;183;Leicht bewölkt;16;16;0
11/08/2019;02:00;155;54;101;Leicht bewölkt;15;15;0
11/08/2019;03:00;80;23;57;Leicht bewölkt;15;15;0
11/08/2019;04:00;51;15;36;Leicht bewölkt;16;16;0
11/08/2019;05:00;46;27;19;Leicht bewölkt;16;16;0
11/08/2019;06:00;57;36;21;Leicht bewölkt;17;17;0
11/08/2019;07:00;77;45;32;Leicht bewölkt;18;18;0
11/08/2019;08:00;134;69;65;Leicht bewölkt;20;20;0
11/08/2019;09:00;326;185;141;Leicht bewölkt;22;22;0
11/08/2019;10:00;515;270;245;Leicht bewölkt;23;24;0
11/08/2019;11:00;698;347;351;Leicht bewölkt;24;25;0
11/08/2019;12:00;723;325;398;Leicht bewölkt;25;27;0
11/08/2019;13:00;802;353;449;Leicht bewölkt;26;27;0
11/08/2019;14:00;826;371;455;Leicht bewölkt;26;27;0
11/08/2019;15:00;772;381;391;Leicht bewölkt;27;28;0
11/08/2019;16:00;723;383;340;Leicht bewölkt;26;28;0
11/08/2019;17:00;919;476;443;Leicht bewölkt;26;27;0
11/08/2019;18:00;947;503;444;Leicht bewölkt;25;27;0
11/08/2019;19:00;494;280;214;Leicht bewölkt;25;26;0
11/08/2019;20:00;220;91;129;Mäßiger bis starker Regenschauer;24;26;1
11/08/2019;21:00;153;72;81;Mäßiger bis starker Regenschauer;23;25;1
11/08/2019;22:00;118;56;62;Mäßiger bis starker Regenschauer;21;21;0
11/08/2019;23:00;81;28;53;Mäßiger bis starker Regenschauer;19;19;1
12/08/2019;00:00;36;19;17;Mäßiger bis starker Regenschauer;17;17;2
12/08/2019;01:00;17;7;10;Mäßiger bis starker Regenschauer;16;16;1
12/08/2019;02:00;6;5;1;Mäßiger bis starker Regenschauer;16;16;0
12/08/2019;03:00;9;2;7;Mäßiger bis starker Regenschauer;15;15;0
12/08/2019;04:00;7;5;2;Mäßiger bis starker Regenschauer;15;15;0
12/08/2019;05:00;64;52;12;Leichter Regenfall;15;15;0
12/08/2019;06:00;187;143;44;Leichter Regenfall;15;15;0
12/08/2019;07:00;291;186;105;Leichter Regenfall;15;15;0
12/08/2019;08:00;394;245;149;Leichter Regenfall;15;15;0
12/08/2019;09:00;402;244;158;Leichter Regenfall;15;15;1
12/08/2019;10:00;369;186;183;Leichter Regenfall;15;15;0
12/08/2019;11:00;367;191;176;Mäßiger Regenfall;15;15;1
12/08/2019;12:00;418;216;202;Mäßiger Regenfall;15;15;2
12/08/2019;13:00;401;213;188;Mäßiger Regenfall;15;15;1
12/08/2019;14:00;417;219;198;Starker Regenfall;15;15;1
12/08/2019;15:00;545;280;265;Starker Regenfall;16;16;2
12/08/2019;16:00;666;337;329;Starker Regenfall;15;15;1
12/08/2019;17:00;719;329;390;Starker Regenfall;15;15;2
12/08/2019;18:00;654;295;359;Starker Regenfall;15;15;2
12/08/2019;19:00;505;219;286;Starker Regenfall;15;15;1
12/08/2019;20:00;379;160;219;Teilweise starker Regenfall;14;14;1
12/08/2019;21:00;218;87;131;Teilweise starker Regenfall;14;14;1
12/08/2019;22:00;209;86;123;Teilweise starker Regenfall;13;13;0
12/08/2019;23:00;140;63;77;Leicht bewölkt;13;13;0
13/08/2019;00:00;51;18;33;Leicht bewölkt;12;12;0
13/08/2019;01:00;54;20;34;Leicht bewölkt;12;12;0
13/08/2019;02:00;13;6;7;Leicht bewölkt;12;12;0
13/08/2019;03:00;13;7;6;Leicht bewölkt;11;12;0
13/08/2019;04:00;14;8;6;Leicht bewölkt;12;12;0
13/08/2019;05:00;70;50;20;Stellenweiser Regenfall;13;13;0
13/08/2019;06:00;242;162;80;Stellenweiser Regenfall;13;13;0
13/08/2019;07:00;533;326;207;Stellenweiser Regenfall;14;14;0
13/08/2019;08:00;658;429;229;Stellenweiser Regenfall;15;15;0
13/08/2019;09:00;734;449;285;Stellenweiser Regenfall;16;16;0
13/08/2019;10:00;785;468;317;Stellenweiser Regenfall;17;17;0
13/08/2019;11:00;874;501;373;Stellenweiser Regenfall;18;18;0
13/08/2019;12:00;892;414;478;Stellenweiser Regenfall;19;19;0
13/08/2019;13:00;935;485;450;Stellenweiser Regenfall;19;19;0
13/08/2019;14:00;934;500;434;Stellenweiser Regenfall;19;19;0
13/08/2019;15:00;1070;540;530;Stellenweiser Regenfall;19;19;0
13/08/2019;16:00;1113;536;577;Stellenweiser Regenfall;18;18;0
13/08/2019;17:00;1302;614;688;Stellenweiser Regenfall;17;17;0
13/08/2019;18:00;1106;464;642;Stellenweiser Regenfall;16;16;0
13/08/2019;19:00;724;306;418;Stellenweiser Regenfall;15;15;0
13/08/2019;20:00;531;227;304;Leichter Regenschauer;14;14;0
13/08/2019;21:00;353;140;213;Leichter Regenschauer;13;14;0
13/08/2019;22:00;288;115;173;Leichter Regenschauer;13;13;0
13/08/2019;23:00;142;53;89;Leichter Regenschauer;12;12;0
14/08/2019;00:00;97;31;66;Leichter Regenschauer;11;12;0
14/08/2019;01:00;37;12;25;Leichter Regenschauer;11;11;0
14/08/2019;02:00;23;9;14;Leichter Regenschauer;10;10;0
14/08/2019;03:00;6;6;0;Leichter Regenschauer;9;9;0
14/08/2019;04:00;12;7;5;Leichter Regenschauer;10;10;0
14/08/2019;05:00;80;58;22;Stellenweiser Regenfall;10;10;0
14/08/2019;06:00;242;162;80;Stellenweiser Regenfall;11;11;0
14/08/2019;07:00;505;289;216;Stellenweiser Regenfall;13;13;0
14/08/2019;08:00;703;449;254;Stellenweiser Regenfall;15;15;0
14/08/2019;09:00;760;467;293;Stellenweiser Regenfall;17;17;0
14/08/2019;10:00;863;497;366;Stellenweiser Regenfall;18;18;0
14/08/2019;11:00;950;502;448;Leicht bewölkt;20;20;0
14/08/2019;12:00;982;509;473;Leicht bewölkt;21;21;0
14/08/2019;13:00;969;517;452;Leicht bewölkt;21;21;0
14/08/2019;14:00;1001;499;502;Leicht bewölkt;22;22;0
14/08/2019;15:00;1119;551;568;Leicht bewölkt;22;22;0
14/08/2019;16:00;1238;622;616;Leicht bewölkt;21;21;0
14/08/2019;17:00;1408;653;755;Leicht bewölkt;20;20;0
14/08/2019;18:00;1239;615;624;Leicht bewölkt;20;20;0
14/08/2019;19:00;926;397;529;Leicht bewölkt;18;18;0
14/08/2019;20:00;671;296;375;Leicht bewölkt;17;17;0
14/08/2019;21:00;498;214;284;Leicht bewölkt;16;16;0
14/08/2019;22:00;352;132;220;Leicht bewölkt;15;15;0
14/08/2019;23:00;208;71;137;Leicht bewölkt;14;14;0
15/08/2019;00:00;108;34;74;Leicht bewölkt;12;12;0
15/08/2019;01:00;54;17;37;Leicht bewölkt;12;12;0
15/08/2019;02:00;25;15;10;Leicht bewölkt;11;11;0
15/08/2019;03:00;20;8;12;Leicht bewölkt;10;11;0
15/08/2019;04:00;18;13;5;Leicht bewölkt;11;11;0
15/08/2019;05:00;85;61;24;Leicht bewölkt;11;12;0
15/08/2019;06:00;218;145;73;Leicht bewölkt;12;12;0
15/08/2019;07:00;444;257;187;Leicht bewölkt;12;13;0
15/08/2019;08:00;645;383;262;Leicht bewölkt;13;13;0
15/08/2019;09:00;636;385;251;Leicht bewölkt;13;14;0
15/08/2019;10:00;614;338;276;Leicht bewölkt;15;15;0
15/08/2019;11:00;654;365;289;Nieselregen;16;17;0
15/08/2019;12:00;740;352;388;Nieselregen;18;18;0
15/08/2019;13:00;732;366;366;Nieselregen;18;19;0
15/08/2019;14:00;667;342;325;Stellenweiser Nieselregen;19;19;0
15/08/2019;15:00;539;254;285;Stellenweiser Nieselregen;20;20;0
15/08/2019;16:00;854;441;413;Stellenweiser Nieselregen;19;19;0
15/08/2019;17:00;943;415;528;Stellenweiser Regenfall;18;17;0
15/08/2019;18:00;926;400;526;Stellenweiser Regenfall;17;16;0
15/08/2019;19:00;574;253;321;Stellenweiser Regenfall;16;15;0
15/08/2019;20:00;428;193;235;Leichter Regenschauer;15;14;0
15/08/2019;21:00;289;135;154;Leichter Regenschauer;14;13;0
15/08/2019;22:00;274;102;172;Leichter Regenschauer;13;13;0
15/08/2019;23:00;164;43;121;Leichter Regenschauer;13;12;0
16/08/2019;00:00;100;33;67;Leichter Regenschauer;12;12;0
16/08/2019;01:00;40;14;26;Leichter Regenschauer;12;12;0
16/08/2019;02:00;18;9;9;Stellenweiser Regenfall;12;12;0
16/08/2019;03:00;8;4;4;Stellenweiser Regenfall;12;13;0
16/08/2019;04:00;10;6;4;Stellenweiser Regenfall;13;13;0
16/08/2019;05:00;51;37;14;Stellenweiser Regenfall;13;13;0
16/08/2019;06:00;196;131;65;Stellenweiser Regenfall;14;14;0
16/08/2019;07:00;412;234;178;Stellenweiser Regenfall;15;15;0
16/08/2019;08:00;598;386;212;Stellenweiser Regenfall;16;16;0
16/08/2019;09:00;812;522;290;Stellenweiser Regenfall;18;18;0
16/08/2019;10:00;934;545;389;Stellenweiser Regenfall;19;19;0
16/08/2019;11:00;1021;589;432;Leicht bewölkt;20;20;0
16/08/2019;12:00;974;474;500;Leicht bewölkt;21;21;0
16/08/2019;13:00;1000;495;505;Leicht bewölkt;22;22;0
16/08/2019;14:00;1044;531;513;Leicht bewölkt;22;24;0
16/08/2019;15:00;939;439;500;Leicht bewölkt;23;25;0
16/08/2019;16:00;1076;469;607;Leicht bewölkt;22;25;0
16/08/2019;17:00;1120;518;602;Leicht bewölkt;22;25;0
16/08/2019;18:00;1023;456;567;Leicht bewölkt;22;22;0
16/08/2019;19:00;779;366;413;Leicht bewölkt;21;21;0
16/08/2019;20:00;610;284;326;Leicht bewölkt;20;20;0
16/08/2019;21:00;457;220;237;Leicht bewölkt;20;20;0
16/08/2019;22:00;324;148;176;Leicht bewölkt;18;18;0
16/08/2019;23:00;272;123;149;Bedeckt;16;16;0
17/08/2019;00:00;171;66;105;Bedeckt;14;14;0
17/08/2019;01:00;117;55;62;Bedeckt;14;14;0
17/08/2019;02:00;45;18;27;Leicht bewölkt;13;13;0
17/08/2019;03:00;51;15;36;Leicht bewölkt;12;12;0
17/08/2019;04:00;25;15;10;Leicht bewölkt;13;13;0
17/08/2019;05:00;42;30;12;Leicht bewölkt;14;14;0
17/08/2019;06:00;69;46;23;Leicht bewölkt;14;14;0
17/08/2019;07:00;124;70;54;Leicht bewölkt;16;16;0
17/08/2019;08:00;278;169;109;Leicht bewölkt;18;18;0
17/08/2019;09:00;545;356;189;Leicht bewölkt;20;20;0
17/08/2019;10:00;681;431;250;Leicht bewölkt;21;21;0
17/08/2019;11:00;902;489;413;Leicht bewölkt;23;24;0
17/08/2019;12:00;861;484;377;Leicht bewölkt;24;25;0
17/08/2019;13:00;871;461;410;Leicht bewölkt;24;26;0
17/08/2019;14:00;845;419;426;Leicht bewölkt;25;26;0
17/08/2019;15:00;920;407;513;Leicht bewölkt;25;26;0
17/08/2019;16:00;873;418;455;Leicht bewölkt;24;26;0
17/08/2019;17:00;877;421;456;Leicht bewölkt;24;26;0
17/08/2019;18:00;606;246;360;Leicht bewölkt;23;26;0
17/08/2019;19:00;483;243;240;Leicht bewölkt;21;21;0
17/08/2019;20:00;391;167;224;Leicht bewölkt;20;20;0
17/08/2019;21:00;288;140;148;Leicht bewölkt;19;19;0
17/08/2019;22:00;247;107;140;Leicht bewölkt;18;18;0
17/08/2019;23:00;181;65;116;Stellenweiser Regenfall;17;17;0
18/08/2019;00:00;205;85;120;Stellenweiser Regenfall;16;16;0
18/08/2019;01:00;93;20;73;Stellenweiser Regenfall;16;16;0
18/08/2019;02:00;54;19;35;Leicht bewölkt;16;16;0
18/08/2019;03:00;39;9;30;Leicht bewölkt;16;16;0
18/08/2019;04:00;20;12;8;Leicht bewölkt;16;16;0
18/08/2019;05:00;21;12;9;Leicht bewölkt;17;17;0
18/08/2019;06:00;43;29;14;Leicht bewölkt;17;17;0
18/08/2019;07:00;88;57;31;Leicht bewölkt;19;19;0
18/08/2019;08:00;164;88;76;Leicht bewölkt;21;21;0
18/08/2019;09:00;364;188;176;Leicht bewölkt;23;24;0
18/08/2019;10:00;592;269;323;Leicht bewölkt;26;26;0
18/08/2019;11:00;684;298;386;Leicht bewölkt;28;28;0
18/08/2019;12:00;786;339;447;Leicht bewölkt;30;31;0
18/08/2019;13:00;755;348;407;Leicht bewölkt;30;31;0
18/08/2019;14:00;863;399;464;Leicht bewölkt;30;31;0
18/08/2019;15:00;770;345;425;Leicht bewölkt;30;32;0
18/08/2019;16:00;782;418;364;Leicht bewölkt;30;31;0
18/08/2019;17:00;846;519;327;Leicht bewölkt;29;31;0
18/08/2019;18:00;828;470;358;Leicht bewölkt;28;30;0
18/08/2019;19:00;735;416;319;Leicht bewölkt;27;29;0
18/08/2019;20:00;463;257;206;Nieselregen mit Gewitter;25;28;0
18/08/2019;21:00;332;146;186;Nieselregen mit Gewitter;24;27;0
18/08/2019;22:00;212;79;133;Nieselregen mit Gewitter;22;25;0
18/08/2019;23:00;91;32;59;Mäßiger bis starker Regenschauer;21;21;0
19/08/2019;00:00;37;18;19;Mäßiger bis starker Regenschauer;19;19;0
19/08/2019;01:00;14;7;7;Mäßiger bis starker Regenschauer;18;18;0
19/08/2019;02:00;6;5;1;Leichter Nebel;18;18;1
19/08/2019;03:00;9;6;3;Leichter Nebel;17;17;1
19/08/2019;04:00;8;7;1;Leichter Nebel;17;17;1
19/08/2019;05:00;52;41;11;Starker Regenfall;17;17;1
19/08/2019;06:00;152;114;38;Starker Regenfall;16;16;2
19/08/2019;07:00;215;130;85;Starker Regenfall;17;17;1
19/08/2019;08:00;414;251;163;Starker Regenfall;18;18;1
19/08/2019;09:00;477;305;172;Starker Regenfall;18;18;1
19/08/2019;10:00;509;306;203;Starker Regenfall;20;20;0
19/08/2019;11:00;601;362;239;Leichter Regenschauer;21;21;0
19/08/2019;12:00;630;329;301;Leichter Regenschauer;22;23;0
19/08/2019;13:00;620;334;286;Leichter Regenschauer;22;24;0
19/08/2019;14:00;677;319;358;Leicht bewölkt;22;24;0
19/08/2019;15:00;718;390;328;Leicht bewölkt;23;25;0
19/08/2019;16:00;808;355;453;Leicht bewölkt;22;22;0
19/08/2019;17:00;932;418;514;Leichter Regenschauer;21;21;0
19/08/2019;18:00;789;330;459;Leichter Regenschauer;20;20;0
19/08/2019;19:00;474;181;293;Leichter Regenschauer;19;19;0
19/08/2019;20:00;351;160;191;Leichter Regenschauer;18;18;0
19/08/2019;21:00;172;80;92;Leichter Regenschauer;17;17;0
19/08/2019;22:00;160;65;95;Leichter Regenschauer;17;17;0
19/08/2019;23:00;88;39;49;Leichter Regenschauer;17;17;0
20/08/2019;00:00;47;11;36;Leichter Regenschauer;16;16;0
20/08/2019;01:00;19;7;12;Leichter Regenschauer;16;16;0
20/08/2019;02:00;10;0;10;Leichter Regenschauer;16;16;0
20/08/2019;03:00;13;6;7;Leichter Regenschauer;15;15;0
20/08/2019;04:00;14;10;4;Leichter Regenschauer;15;15;0
20/08/2019;05:00;57;41;16;Nieselregen;15;15;0
20/08/2019;06:00;178;120;58;Nieselregen;16;16;0
20/08/2019;07:00;369;219;150;Nieselregen;16;16;0
20/08/2019;08:00;467;292;175;Leichter Regenfall;16;16;0
20/08/2019;09:00;415;273;142;Leichter Regenfall;16;16;0
20/08/2019;10:00;354;196;158;Leichter Regenfall;16;15;0
20/08/2019;11:00;255;123;132;Leichter Regenfall;15;15;0
20/08/2019;12:00;273;106;167;Leichter Regenfall;15;14;1
20/08/2019;13:00;313;145;168;Leichter Regenfall;15;14;0
20/08/2019;14:00;296;155;141;Mäßiger Regenfall;14;14;1
20/08/2019;15:00;322;147;175;Mäßiger Regenfall;14;14;1
20/08/2019;16:00;387;173;214;Mäßiger Regenfall;14;14;0
20/08/2019;17:00;496;238;258;Mäßiger Regenfall;13;13;0
20/08/2019;18:00;392;163;229;Mäßiger Regenfall;13;13;0
20/08/2019;19:00;255;92;163;Mäßiger Regenfall;13;13;0
20/08/2019;20:00;160;63;97;Nebel;13;13;1
20/08/2019;21:00;106;57;49;Nebel;12;12;1
20/08/2019;22:00;107;53;54;Nebel;12;12;1
20/08/2019;23:00;74;29;45;Starker Regenfall;12;12;1
21/08/2019;00:00;40;15;25;Starker Regenfall;12;12;2
21/08/2019;01:00;27;7;20;Starker Regenfall;12;11;1
21/08/2019;02:00;6;0;6;Mäßiger Regenfall;11;11;0
21/08/2019;03:00;9;4;5;Mäßiger Regenfall;11;10;0
21/08/2019;04:00;4;4;0;Mäßiger Regenfall;11;10;0
21/08/2019;05:00;67;46;21;Leichter Nebel;11;11;0
21/08/2019;06:00;186;124;62;Leichter Nebel;11;11;0
21/08/2019;07:00;466;280;186;Leichter Nebel;13;12;0
21/08/2019;08:00;589;374;215;Leichter Nebel;14;14;0
21/08/2019;09:00;653;403;250;Leichter Nebel;15;15;0
21/08/2019;10:00;750;428;322;Leichter Nebel;17;16;0
21/08/2019;11:00;797;413;384;Leicht bewölkt;18;18;0
21/08/2019;12:00;879;452;427;Leicht bewölkt;19;19;0
21/08/2019;13:00;877;419;458;Leicht bewölkt;20;20;0
21/08/2019;14:00;955;490;465;Leicht bewölkt;20;20;0
21/08/2019;15:00;918;425;493;Leicht bewölkt;20;20;0
21/08/2019;16:00;1130;538;592;Leicht bewölkt;20;20;0
21/08/2019;17:00;1171;542;629;Leicht bewölkt;19;19;0
21/08/2019;18:00;1042;485;557;Leicht bewölkt;18;18;0
21/08/2019;19:00;731;338;393;Leicht bewölkt;17;17;0
21/08/2019;20:00;554;247;307;Leicht bewölkt;16;15;0
21/08/2019;21:00;317;131;186;Leicht bewölkt;15;14;0
21/08/2019;22:00;308;94;214;Leicht bewölkt;14;13;0
21/08/2019;23:00;163;68;95;Leicht bewölkt;14;13;0
22/08/2019;00:00;104;41;63;Leicht bewölkt;13;12;0
22/08/2019;01:00;49;17;32;Leicht bewölkt;13;12;0
22/08/2019;02:00;26;8;18;Leicht bewölkt;12;11;0
22/08/2019;03:00;11;3;8;Leicht bewölkt;12;11;0
22/08/2019;04:00;17;11;6;Leicht bewölkt;12;11;0
22/08/2019;05:00;78;48;30;Leicht bewölkt;12;12;0
22/08/2019;06:00;200;130;70;Leicht bewölkt;12;12;0
22/08/2019;07:00;424;259;165;Leicht bewölkt;14;13;0
22/08/2019;08:00;581;372;209;Leicht bewölkt;15;15;0
22/08/2019;09:00;667;375;292;Leicht bewölkt;16;16;0
22/08/2019;10:00;708;425;283;Leicht bewölkt;18;18;0
22/08/2019;11:00;789;471;318;Leicht bewölkt;19;19;0
22/08/2019;12:00;740;360;380;Leicht bewölkt;20;20;0
22/08/2019;13:00;778;399;379;Leicht bewölkt;21;21;0
22/08/2019;14:00;851;431;420;Leicht bewölkt;21;21;0
22/08/2019;15:00;1021;513;508;Leicht bewölkt;22;22;0
22/08/2019;16:00;1063;510;553;Leicht bewölkt;21;21;0
22/08/2019;17:00;1122;539;583;Leicht bewölkt;20;20;0
22/08/2019;18:00;997;428;569;Leicht bewölkt;19;19;0
22/08/2019;19:00;844;415;429;Leicht bewölkt;18;18;0
22/08/2019;20:00;517;216;301;Leicht bewölkt;17;17;0
22/08/2019;21:00;389;143;246;Leicht bewölkt;16;16;0
22/08/2019;22:00;309;109;200;Leicht bewölkt;15;15;0
22/08/2019;23:00;167;57;110;Leicht bewölkt;14;14;0
23/08/2019;00:00;72;22;50;Leicht bewölkt;13;13;0
23/08/2019;01:00;50;16;34;Leicht bewölkt;13;13;0
23/08/2019;02:00;21;7;14;Leichter Nebel;12;12;0
23/08/2019;03:00;5;4;1;Leichter Nebel;11;11;0
23/08/2019;04:00;8;6;2;Leichter Nebel;12;12;0
23/08/2019;05:00;51;33;18;Leichter Nebel;12;12;0
23/08/2019;06:00;186;120;66;Leichter Nebel;13;13;0
23/08/2019;07:00;403;240;163;Leichter Nebel;14;14;0
23/08/2019;08:00;586;373;213;Leichter Nebel;16;16;0
23/08/2019;09:00;685;434;251;Leichter Nebel;17;18;0
23/08/2019;10:00;774;446;328;Leichter Nebel;19;19;0
23/08/2019;11:00;927;509;418;Leicht bewölkt;20;20;0
23/08/2019;12:00;860;419;441;Leicht bewölkt;22;22;0
23/08/2019;13:00;873;440;433;Leicht bewölkt;22;22;0
23/08/2019;14:00;905;443;462;Leicht bewölkt;22;24;0
23/08/2019;15:00;955;473;482;Leicht bewölkt;23;25;0
23/08/2019;16:00;990;463;527;Leicht bewölkt;23;25;0
23/08/2019;17:00;1039;522;517;Leicht bewölkt;22;25;0
23/08/2019;18:00;937;413;524;Leicht bewölkt;22;22;0
23/08/2019;19:00;805;405;400;Leicht bewölkt;21;21;0
23/08/2019;20:00;561;254;307;Leicht bewölkt;20;20;0
23/08/2019;21:00;396;182;214;Leicht bewölkt;18;18;0
23/08/2019;22:00;292;140;152;Leicht bewölkt;17;17;0
23/08/2019;23:00;253;89;164;Leicht bewölkt;16;16;0
24/08/2019;00:00;142;56;86;Leicht bewölkt;15;15;0
24/08/2019;01:00;92;24;68;Leicht bewölkt;14;14;0
24/08/2019;02:00;61;20;41;Leichter Nebel;14;14;0
24/08/2019;03:00;42;13;29;Leichter Nebel;13;13;0
24/08/2019;04:00;27;10;17;Leichter Nebel;14;14;0
24/08/2019;05:00;34;22;12;Leichter Nebel;14;14;0
24/08/2019;06:00;67;40;27;Leichter Nebel;15;15;0
24/08/2019;07:00;118;76;42;Leichter Nebel;16;16;0
24/08/2019;08:00;266;154;112;Leichter Nebel;17;17;0
24/08/2019;09:00;517;326;191;Leichter Nebel;19;19;0
24/08/2019;10:00;740;425;315;Leichter Nebel;20;20;0
24/08/2019;11:00;848;432;416;Bewölkt;22;22;0
24/08/2019;12:00;860;470;390;Bewölkt;23;24;0
24/08/2019;13:00;793;414;379;Bewölkt;23;25;0
24/08/2019;14:00;915;423;492;Leicht bewölkt;24;25;0
24/08/2019;15:00;971;484;487;Leicht bewölkt;24;26;0
24/08/2019;16:00;839;374;465;Leicht bewölkt;23;24;0
24/08/2019;17:00;950;462;488;Stellenweiser Regenfall;22;22;0
24/08/2019;18:00;853;408;445;Stellenweiser Regenfall;21;21;0
24/08/2019;19:00;709;388;321;Stellenweiser Regenfall;20;20;0
24/08/2019;20:00;582;271;311;Stellenweiser Regenfall;18;18;0
24/08/2019;21:00;369;170;199;Stellenweiser Regenfall;17;17;0
24/08/2019;22:00;312;138;174;Stellenweiser Regenfall;17;17;0
24/08/2019;23:00;242;81;161;Teilweise mäßiger Regenfall;16;16;0
25/08/2019;00:00;183;76;107;Teilweise mäßiger Regenfall;16;16;0
25/08/2019;01:00;98;45;53;Teilweise mäßiger Regenfall;15;15;0
25/08/2019;02:00;75;30;45;Leichter Nebel;15;15;0
25/08/2019;03:00;69;26;43;Leichter Nebel;14;14;0
25/08/2019;04:00;18;7;11;Leichter Nebel;15;15;0
25/08/2019;05:00;21;13;8;Leicht bewölkt;15;15;0
25/08/2019;06:00;47;29;18;Leicht bewölkt;16;16;0
25/08/2019;07:00;63;43;20;Leicht bewölkt;18;18;0
25/08/2019;08:00;136;73;63;Leicht bewölkt;20;20;0
25/08/2019;09:00;295;156;139;Leicht bewölkt;22;23;0
25/08/2019;10:00;383;190;193;Leicht bewölkt;24;25;0
25/08/2019;11:00;518;283;235;Sonnig;25;26;0
25/08/2019;12:00;570;268;302;Sonnig;27;28;0
25/08/2019;13:00;628;268;360;Sonnig;27;28;0
25/08/2019;14:00;770;353;417;Leicht bewölkt;27;28;0
25/08/2019;15:00;747;341;406;Leicht bewölkt;28;28;0
25/08/2019;16:00;787;399;388;Leicht bewölkt;27;28;0
25/08/2019;17:00;793;427;366;Leicht bewölkt;26;27;0
25/08/2019;18:00;797;459;338;Leicht bewölkt;25;27;0
25/08/2019;19:00;578;325;253;Leicht bewölkt;24;26;0
25/08/2019;20:00;474;211;263;Leicht bewölkt;23;26;0
25/08/2019;21:00;285;110;175;Leicht bewölkt;22;25;0
25/08/2019;22:00;196;98;98;Leicht bewölkt;21;21;0
25/08/2019;23:00;118;48;70;Leicht bewölkt;19;19;0
26/08/2019;00:00;49;14;35;Leicht bewölkt;18;18;0
26/08/2019;01:00;29;11;18;Leicht bewölkt;17;17;0
26/08/2019;02:00;16;9;7;Leicht bewölkt;16;16;0
26/08/2019;03:00;7;2;5;Leicht bewölkt;15;15;0
26/08/2019;04:00;20;16;4;Leicht bewölkt;15;15;0
26/08/2019;05:00;72;49;23;Leicht bewölkt;16;16;0
26/08/2019;06:00;233;156;77;Leicht bewölkt;16;16;0
26/08/2019;07:00;503;301;202;Leicht bewölkt;18;18;0
26/08/2019;08:00;690;406;284;Leicht bewölkt;20;20;0
26/08/2019;09:00;703;446;257;Leicht bewölkt;22;22;0
26/08/2019;10:00;806;453;353;Leicht bewölkt;23;24;0
26/08/2019;11:00;806;453;353;Leicht bewölkt;25;26;0
26/08/2019;12:00;830;367;463;Leicht bewölkt;26;27;0
26/08/2019;13:00;805;412;393;Leicht bewölkt;26;28;0
26/08/2019;14:00;978;513;465;Leicht bewölkt;27;28;0
26/08/2019;15:00;927;456;471;Leicht bewölkt;27;29;0
26/08/2019;16:00;1131;550;581;Leicht bewölkt;27;29;0
26/08/2019;17:00;1134;488;646;Teilweise mäßiger Regenfall;26;29;0
26/08/2019;18:00;1139;493;646;Teilweise mäßiger Regenfall;26;29;0
26/08/2019;19:00;811;401;410;Teilweise mäßiger Regenfall;25;28;0
26/08/2019;20:00;618;266;352;Leicht bewölkt;25;28;0
26/08/2019;21:00;387;165;222;Leicht bewölkt;24;27;0
26/08/2019;22:00;250;98;152;Leicht bewölkt;22;22;0
26/08/2019;23:00;148;49;99;Leicht bewölkt;20;20;0
27/08/2019;00:00;113;52;61;Leicht bewölkt;18;18;0
27/08/2019;01:00;24;6;18;Leicht bewölkt;17;17;0
27/08/2019;02:00;13;5;8;Leicht bewölkt;17;17;0
27/08/2019;03:00;10;5;5;Leicht bewölkt;16;16;0
27/08/2019;04:00;16;10;6;Leicht bewölkt;17;17;0
27/08/2019;05:00;67;44;23;Sonnig;17;17;0
27/08/2019;06:00;239;159;80;Sonnig;18;18;0
27/08/2019;07:00;547;319;228;Sonnig;20;20;0
27/08/2019;08:00;783;485;298;Sonnig;21;21;0
27/08/2019;09:00;779;469;310;Sonnig;23;24;0
27/08/2019;10:00;841;484;357;Sonnig;24;25;0
27/08/2019;11:00;887;440;447;Sonnig;25;26;0
27/08/2019;12:00;952;437;515;Sonnig;27;27;0
27/08/2019;13:00;924;448;476;Sonnig;27;28;0
27/08/2019;14:00;943;437;506;Leicht bewölkt;28;28;0
27/08/2019;15:00;946;447;499;Leicht bewölkt;28;29;0
27/08/2019;16:00;1091;512;579;Leicht bewölkt;28;29;0
27/08/2019;17:00;1311;581;730;Leicht bewölkt;28;30;0
27/08/2019;18:00;1150;538;612;Leicht bewölkt;27;30;0
27/08/2019;19:00;889;420;469;Leicht bewölkt;27;30;0
27/08/2019;20:00;689;281;408;Leicht bewölkt;26;29;0
27/08/2019;21:00;466;212;254;Leicht bewölkt;25;28;0
27/08/2019;22:00;280;103;177;Leicht bewölkt;23;26;0
27/08/2019;23:00;161;48;113;Leicht bewölkt;21;21;0
28/08/2019;00:00;79;20;59;Leicht bewölkt;20;20;0
28/08/2019;01:00;52;15;37;Leicht bewölkt;19;19;0
28/08/2019;02:00;20;9;11;Leicht bewölkt;18;18;0
28/08/2019;03:00;7;4;3;Leicht bewölkt;17;17;0
28/08/2019;04:00;12;9;3;Leicht bewölkt;17;17;0
28/08/2019;05:00;69;51;18;Nieselregen mit Gewitter;17;17;0
28/08/2019;06:00;231;146;85;Nieselregen mit Gewitter;17;17;0
28/08/2019;07:00;556;337;219;Nieselregen mit Gewitter;19;19;0
28/08/2019;08:00;698;439;259;Leichter Regenschauer;20;20;0
28/08/2019;09:00;755;483;272;Leichter Regenschauer;21;21;0
28/08/2019;10:00;797;485;312;Leichter Regenschauer;23;24;0
28/08/2019;11:00;935;480;455;Leicht bewölkt;25;26;0
28/08/2019;12:00;947;455;492;Leicht bewölkt;27;28;0
28/08/2019;13:00;934;418;516;Leicht bewölkt;27;29;0
28/08/2019;14:00;906;414;492;Leicht bewölkt;28;29;0
28/08/2019;15:00;927;437;490;Leicht bewölkt;28;29;0
28/08/2019;16:00;1156;567;589;Leicht bewölkt;27;29;0
28/08/2019;17:00;1207;597;610;Stellenweiser Regenfall;27;28;0
28/08/2019;18:00;1136;541;595;Stellenweiser Regenfall;26;28;0
28/08/2019;19:00;870;433;437;Stellenweiser Regenfall;25;27;0
28/08/2019;20:00;637;273;364;Stellenweiser Regenfall;24;26;0
28/08/2019;21:00;407;172;235;Stellenweiser Regenfall;22;26;0
28/08/2019;22:00;277;112;165;Stellenweiser Regenfall;21;21;0
28/08/2019;23:00;163;55;108;Stellenweiser Regenfall;19;19;0
29/08/2019;00:00;115;40;75;Stellenweiser Regenfall;18;18;0
29/08/2019;01:00;42;8;34;Stellenweiser Regenfall;17;17;0
29/08/2019;02:00;15;4;11;Leichter Regenschauer;16;16;0
29/08/2019;03:00;16;4;12;Leichter Regenschauer;16;16;0
29/08/2019;04:00;17;11;6;Leichter Regenschauer;16;16;0
29/08/2019;05:00;72;52;20;Stellenweiser Regenfall;16;16;0
29/08/2019;06:00;208;136;72;Stellenweiser Regenfall;16;16;0
29/08/2019;07:00;406;224;182;Stellenweiser Regenfall;17;17;0
29/08/2019;08:00;487;310;177;Leicht bewölkt;18;18;0
29/08/2019;09:00;490;299;191;Leicht bewölkt;20;20;0
29/08/2019;10:00;603;384;219;Leicht bewölkt;21;21;0
29/08/2019;11:00;633;352;281;Leichter Regenschauer;23;24;0
29/08/2019;12:00;699;346;353;Leichter Regenschauer;25;26;0
29/08/2019;13:00;808;430;378;Leichter Regenschauer;25;26;0
29/08/2019;14:00;826;417;409;Stellenweiser Regenfall;26;27;0
29/08/2019;15:00;812;395;417;Stellenweiser Regenfall;27;28;0
29/08/2019;16:00;926;462;464;Stellenweiser Regenfall;26;28;0
29/08/2019;17:00;1031;482;549;Stellenweiser Regenfall;26;27;0
29/08/2019;18:00;948;404;544;Stellenweiser Regenfall;25;27;0
29/08/2019;19:00;775;365;410;Stellenweiser Regenfall;24;26;0
29/08/2019;20:00;492;228;264;Leicht bewölkt;23;24;0
29/08/2019;21:00;368;164;204;Leicht bewölkt;21;21;0
29/08/2019;22:00;269;76;193;Leicht bewölkt;20;20;0
29/08/2019;23:00;181;63;118;Mäßiger bis starker Regenschauer;19;19;0
30/08/2019;00:00;97;26;71;Mäßiger bis starker Regenschauer;17;17;1
30/08/2019;01:00;47;16;31;Mäßiger bis starker Regenschauer;17;17;0
30/08/2019;02:00;18;12;6;Mäßiger bis starker Regenschauer;16;16;0
30/08/2019;03:00;11;5;6;Mäßiger bis starker Regenschauer;15;15;0
30/08/2019;04:00;17;12;5;Mäßiger bis starker Regenschauer;16;16;0
30/08/2019;05:00;56;36;20;Leicht bewölkt;16;16;0
30/08/2019;06:00;202;134;68;Leicht bewölkt;16;16;0
30/08/2019;07:00;497;291;206;Leicht bewölkt;18;18;0
30/08/2019;08:00;715;446;269;Leicht bewölkt;20;20;0
30/08/2019;09:00;805;514;291;Leicht bewölkt;22;22;0
30/08/2019;10:00;947;565;382;Leicht bewölkt;23;24;0
30/08/2019;11:00;897;480;417;Leicht bewölkt;24;26;0
30/08/2019;12:00;968;457;511;Leicht bewölkt;26;27;0
30/08/2019;13:00;946;413;533;Leicht bewölkt;26;27;0
30/08/2019;14:00;942;462;480;Leicht bewölkt;26;28;0
30/08/2019;15:00;956;451;505;Leicht bewölkt;26;28;0
30/08/2019;16:00;980;483;497;Leicht bewölkt;26;27;0
30/08/2019;17:00;1008;517;491;Stellenweiser Regenfall;25;27;0
30/08/2019;18:00;983;519;464;Stellenweiser Regenfall;24;27;0
30/08/2019;19:00;950;526;424;Stellenweiser Regenfall;23;26;0
30/08/2019;20:00;615;280;335;Leicht bewölkt;22;25;0
30/08/2019;21:00;453;183;270;Leicht bewölkt;21;21;0
30/08/2019;22:00;380;124;256;Leicht bewölkt;20;20;0
30/08/2019;23:00;287;68;219;Leicht bewölkt;19;19;0
31/08/2019;00:00;160;49;111;Leicht bewölkt;17;17;0
31/08/2019;01:00;101;34;67;Leicht bewölkt;17;17;0
31/08/2019;02:00;54;25;29;Leicht bewölkt;16;16;0
31/08/2019;03:00;33;7;26;Leicht bewölkt;15;15;0
31/08/2019;04:00;23;17;6;Leicht bewölkt;15;15;0
31/08/2019;05:00;38;27;11;Leicht bewölkt;16;16;0
31/08/2019;06:00;52;36;16;Leicht bewölkt;16;16;0
31/08/2019;07:00;114;77;37;Leicht bewölkt;17;17;0
31/08/2019;08:00;307;205;102;Leicht bewölkt;19;19;0
31/08/2019;09:00;562;374;188;Leicht bewölkt;21;21;0
31/08/2019;10:00;825;477;348;Leicht bewölkt;23;24;0
31/08/2019;11:00;878;525;353;Leicht bewölkt;25;26;0
31/08/2019;12:00;894;421;473;Leicht bewölkt;26;28;0
31/08/2019;13:00;911;396;515;Leicht bewölkt;27;28;0
31/08/2019;14:00;966;457;509;Leicht bewölkt;27;28;0
31/08/2019;15:00;856;408;448;Leicht bewölkt;27;29;0
31/08/2019;16:00;913;451;462;Leicht bewölkt;26;28;0
31/08/2019;17:00;985;514;471;Stellenweiser Regenfall;25;28;0
31/08/2019;18:00;938;438;500;Stellenweiser Regenfall;24;27;0
31/08/2019;19:00;679;343;336;Stellenweiser Regenfall;23;25;0
31/08/2019;20:00;583;276;307;Stellenweiser Regenfall;21;21;0
31/08/2019;21:00;435;187;248;Stellenweiser Regenfall;20;20;0
31/08/2019;22:00;336;135;201;Stellenweiser Regenfall;19;19;0
31/08/2019;23:00;226;62;164;Leicht bewölkt;18;18;0
01/09/2019;00:00;149;63;86;Leicht bewölkt;17;17;0
01/09/2019;01:00;130;41;89;Leicht bewölkt;16;16;0
01/09/2019;02:00;88;37;51;Stellenweiser Regenfall;16;16;0
01/09/2019;03:00;60;28;32;Stellenweiser Regenfall;16;16;0
01/09/2019;04:00;27;22;5;Stellenweiser Regenfall;15;15;0
01/09/2019;05:00;35;30;5;Leicht bewölkt;15;15;0
01/09/2019;06:00;52;38;14;Leicht bewölkt;15;15;0
01/09/2019;07:00;57;42;15;Leicht bewölkt;17;17;0
01/09/2019;08:00;135;81;54;Stellenweiser Regenfall;18;18;0
01/09/2019;09:00;288;152;136;Stellenweiser Regenfall;19;19;0
01/09/2019;10:00;295;205;90;Stellenweiser Regenfall;21;21;0
01/09/2019;11:00;304;164;140;Stellenweiser Regenfall;22;22;0
01/09/2019;12:00;379;199;180;Stellenweiser Regenfall;23;25;0
01/09/2019;13:00;383;219;164;Stellenweiser Regenfall;23;25;0
01/09/2019;14:00;420;202;218;Leicht bewölkt;23;25;0
01/09/2019;15:00;559;310;249;Leicht bewölkt;23;25;0
01/09/2019;16:00;541;276;265;Leicht bewölkt;22;25;0
01/09/2019;17:00;592;310;282;Mäßiger bis starker Regenschauer;21;21;1
01/09/2019;18:00;474;200;274;Mäßiger bis starker Regenschauer;21;21;1
01/09/2019;19:00;468;199;269;Mäßiger bis starker Regenschauer;20;20;0
01/09/2019;20:00;254;86;168;Sintflutartiger Regenfall;19;19;1
01/09/2019;21:00;162;54;108;Sintflutartiger Regenfall;18;18;1
01/09/2019;22:00;103;42;61;Sintflutartiger Regenfall;17;17;0
01/09/2019;23:00;66;31;35;Mäßiger Regenfall;16;16;0
02/09/2019;00:00;29;12;17;Mäßiger Regenfall;15;16;1
02/09/2019;01:00;14;7;7;Mäßiger Regenfall;15;15;0
02/09/2019;02:00;8;5;3;Mäßiger Regenfall;15;15;0
02/09/2019;03:00;2;2;0;Mäßiger Regenfall;15;15;0
02/09/2019;04:00;7;6;1;Mäßiger Regenfall;15;15;0
02/09/2019;05:00;63;46;17;Nieselregen;15;15;0
02/09/2019;06:00;201;135;66;Nieselregen;15;14;0
02/09/2019;07:00;469;294;175;Nieselregen;15;15;0
02/09/2019;08:00;599;360;239;Nieselregen;15;15;0
02/09/2019;09:00;599;362;237;Nieselregen;16;16;0
02/09/2019;10:00;483;280;203;Nieselregen;16;16;0
02/09/2019;11:00;550;291;259;Stellenweiser Regenfall;16;16;0
02/09/2019;12:00;589;269;320;Stellenweiser Regenfall;16;16;0
02/09/2019;13:00;690;364;326;Stellenweiser Regenfall;16;16;0
02/09/2019;14:00;705;387;318;Nieselregen;16;16;0
02/09/2019;15:00;782;423;359;Nieselregen;16;16;0
02/09/2019;16:00;881;407;474;Nieselregen;15;15;0
02/09/2019;17:00;948;405;543;Stellenweiser Regenfall;14;14;0
02/09/2019;18:00;793;351;442;Stellenweiser Regenfall;13;13;0
02/09/2019;19:00;562;233;329;Stellenweiser Regenfall;13;12;0
02/09/2019;20:00;400;167;233;Stellenweiser Nieselregen;12;11;0
02/09/2019;21:00;238;98;140;Stellenweiser Nieselregen;11;10;0
02/09/2019;22:00;191;86;105;Stellenweiser Nieselregen;10;10;0
02/09/2019;23:00;98;38;60;Leicht bewölkt;10;9;0
03/09/2019;00:00;64;27;37;Leicht bewölkt;9;9;0
03/09/2019;01:00;35;14;21;Leicht bewölkt;9;9;0
03/09/2019;02:00;11;10;1;Leicht bewölkt;9;9;0
03/09/2019;03:00;9;5;4;Leicht bewölkt;9;9;0
03/09/2019;04:00;13;11;2;Leicht bewölkt;9;9;0
03/09/2019;05:00;76;53;23;Leicht bewölkt;10;10;0
03/09/2019;06:00;234;162;72;Leicht bewölkt;10;10;0
03/09/2019;07:00;625;383;242;Leicht bewölkt;12;12;0
03/09/2019;08:00;890;550;340;Leicht bewölkt;14;14;0
03/09/2019;09:00;746;472;274;Leicht bewölkt;16;16;0
03/09/2019;10:00;783;473;310;Leicht bewölkt;17;17;0
03/09/2019;11:00;828;436;392;Leicht bewölkt;18;18;0
03/09/2019;12:00;939;445;494;Leicht bewölkt;20;20;0
03/09/2019;13:00;882;453;429;Leicht bewölkt;20;20;0
03/09/2019;14:00;978;493;485;Leicht bewölkt;20;20;0
03/09/2019;15:00;1103;556;547;Leicht bewölkt;21;21;0
03/09/2019;16:00;1235;600;635;Leicht bewölkt;20;20;0
03/09/2019;17:00;1359;627;732;Leicht bewölkt;20;20;0
03/09/2019;18:00;1170;522;648;Leicht bewölkt;19;19;0
03/09/2019;19:00;860;382;478;Leicht bewölkt;18;18;0
03/09/2019;20:00;602;263;339;Leicht bewölkt;17;17;0
03/09/2019;21:00;358;149;209;Leicht bewölkt;16;16;0
03/09/2019;22:00;305;109;196;Leicht bewölkt;15;15;0
03/09/2019;23:00;162;64;98;Leicht bewölkt;14;14;0
04/09/2019;00:00;77;31;46;Leicht bewölkt;12;12;0
04/09/2019;01:00;35;15;20;Leicht bewölkt;11;11;0
04/09/2019;02:00;20;12;8;Leicht bewölkt;11;11;0
04/09/2019;03:00;9;6;3;Leicht bewölkt;10;10;0
04/09/2019;04:00;12;4;8;Leicht bewölkt;11;11;0
04/09/2019;05:00;71;54;17;Leicht bewölkt;12;12;0
04/09/2019;06:00;229;150;79;Leicht bewölkt;12;12;0
04/09/2019;07:00;646;373;273;Leicht bewölkt;14;14;0
04/09/2019;08:00;870;522;348;Leicht bewölkt;16;16;0
04/09/2019;09:00;743;487;256;Leicht bewölkt;18;18;0
04/09/2019;10:00;744;410;334;Leicht bewölkt;20;20;0
04/09/2019;11:00;774;365;409;Leicht bewölkt;21;21;0
04/09/2019;12:00;959;453;506;Leicht bewölkt;23;24;0
04/09/2019;13:00;973;457;516;Leicht bewölkt;24;25;0
04/09/2019;14:00;1069;520;549;Leicht bewölkt;24;25;0
04/09/2019;15:00;1094;547;547;Leicht bewölkt;25;26;0
04/09/2019;16:00;1277;610;667;Leicht bewölkt;24;26;0
04/09/2019;17:00;1342;627;715;Sonnig;24;25;0
04/09/2019;18:00;1323;652;671;Sonnig;23;25;0
04/09/2019;19:00;922;429;493;Sonnig;23;25;0
04/09/2019;20:00;611;274;337;Leicht bewölkt;22;22;0
04/09/2019;21:00;384;171;213;Leicht bewölkt;21;21;0
04/09/2019;22:00;297;111;186;Leicht bewölkt;19;19;0
04/09/2019;23:00;183;61;122;Leicht bewölkt;17;17;0
05/09/2019;00:00;79;18;61;Leicht bewölkt;14;14;0
05/09/2019;01:00;59;16;43;Leicht bewölkt;13;13;0
05/09/2019;02:00;22;7;15;Leicht bewölkt;12;12;0
05/09/2019;03:00;5;4;1;Leicht bewölkt;11;11;0
05/09/2019;04:00;13;9;4;Leicht bewölkt;12;12;0
05/09/2019;05:00;88;62;26;Leicht bewölkt;12;12;0
05/09/2019;06:00;213;134;79;Leicht bewölkt;12;13;0
05/09/2019;07:00;539;339;200;Leicht bewölkt;14;14;0
05/09/2019;08:00;796;459;337;Leicht bewölkt;15;15;0
05/09/2019;09:00;717;445;272;Leicht bewölkt;16;16;0
05/09/2019;10:00;751;425;326;Leicht bewölkt;15;15;0
05/09/2019;11:00;563;292;271;Leichter Regenschauer;15;15;0
05/09/2019;12:00;569;280;289;Leichter Regenschauer;14;14;0
05/09/2019;13:00;544;221;323;Leichter Regenschauer;14;14;0
05/09/2019;14:00;404;188;216;Leichter Regenschauer;13;13;0
05/09/2019;15:00;509;234;275;Leichter Regenschauer;13;13;0
05/09/2019;16:00;733;405;328;Leichter Regenschauer;12;12;0
05/09/2019;17:00;940;463;477;Leichter Regenfall;12;12;0
05/09/2019;18:00;730;317;413;Leichter Regenfall;11;11;0
05/09/2019;19:00;554;263;291;Leichter Regenfall;11;11;0
05/09/2019;20:00;321;156;165;Stellenweiser Nieselregen;10;10;0
05/09/2019;21:00;224;98;126;Stellenweiser Nieselregen;10;10;0
05/09/2019;22:00;228;80;148;Stellenweiser Nieselregen;10;10;0
05/09/2019;23:00;128;42;86;Bewölkt;10;10;0
06/09/2019;00:00;61;21;40;Bewölkt;10;10;0
06/09/2019;01:00;34;7;27;Bewölkt;10;9;0
06/09/2019;02:00;15;5;10;Leicht bewölkt;9;9;0
06/09/2019;03:00;10;7;3;Leicht bewölkt;9;8;0
06/09/2019;04:00;11;8;3;Leicht bewölkt;9;8;0
06/09/2019;05:00;56;38;18;Leicht bewölkt;9;8;0
06/09/2019;06:00;178;114;64;Leicht bewölkt;10;8;0
06/09/2019;07:00;477;303;174;Leicht bewölkt;10;9;0
06/09/2019;08:00;694;427;267;Stellenweiser Regenfall;11;9;0
06/09/2019;09:00;682;445;237;Stellenweiser Regenfall;11;10;0
06/09/2019;10:00;658;410;248;Stellenweiser Regenfall;12;11;0
06/09/2019;11:00;676;366;310;Bewölkt;13;12;0
06/09/2019;12:00;810;363;447;Bewölkt;14;14;0
06/09/2019;13:00;726;343;383;Bewölkt;14;14;0
06/09/2019;14:00;809;416;393;Bewölkt;15;15;0
06/09/2019;15:00;806;417;389;Bewölkt;15;15;0
06/09/2019;16:00;874;447;427;Bewölkt;15;14;0
06/09/2019;17:00;786;348;438;Leichter Regenschauer;14;14;0
06/09/2019;18:00;696;296;400;Leichter Regenschauer;13;13;0
06/09/2019;19:00;506;249;257;Leichter Regenschauer;13;12;0
06/09/2019;20:00;335;128;207;Leichter Regenschauer;12;12;0
06/09/2019;21:00;232;105;127;Leichter Regenschauer;12;11;0
06/09/2019;22:00;198;79;119;Leichter Regenschauer;12;11;0
06/09/2019;23:00;151;64;87;Leichter Regenschauer;12;11;0
07/09/2019;00:00;169;47;122;Leichter Regenschauer;11;12;0
07/09/2019;01:00;78;19;59;Leichter Regenschauer;11;11;0
07/09/2019;02:00;72;21;51;Stellenweiser leichter Regenfall;11;11;0
07/09/2019;03:00;44;15;29;Stellenweiser leichter Regenfall;11;11;0
07/09/2019;04:00;11;9;2;Stellenweiser leichter Regenfall;11;11;0
07/09/2019;05:00;30;15;15;Nieselregen;11;11;0
07/09/2019;06:00;70;45;25;Nieselregen;11;12;0
07/09/2019;07:00;152;53;99;Nieselregen;12;12;0
07/09/2019;08:00;348;117;231;Leichter Regenschauer;12;12;0
07/09/2019;09:00;469;273;196;Leichter Regenschauer;13;13;0
07/09/2019;10:00;655;375;280;Leichter Regenschauer;12;12;0
07/09/2019;11:00;707;404;303;Leichter Regenschauer;12;12;0
07/09/2019;12:00;735;436;299;Leichter Regenschauer;12;11;0
07/09/2019;13:00;811;442;369;Leichter Regenschauer;12;11;0
07/09/2019;14:00;802;365;437;Mäßiger Regenfall;12;11;0
07/09/2019;15:00;889;410;479;Mäßiger Regenfall;12;11;0
07/09/2019;16:00;741;265;476;Mäßiger Regenfall;11;10;0
07/09/2019;17:00;739;222;517;Stellenweiser Nieselregen;11;10;0
07/09/2019;18:00;599;223;376;Stellenweiser Nieselregen;10;10;0
07/09/2019;19:00;421;205;216;Stellenweiser Nieselregen;9;9;0
07/09/2019;20:00;254;114;140;Stellenweiser Regenfall;9;8;0
07/09/2019;21:00;252;131;121;Stellenweiser Regenfall;8;8;0
07/09/2019;22:00;120;54;66;Stellenweiser Regenfall;7;7;0
07/09/2019;23:00;138;54;84;Leicht bewölkt;7;7;0
08/09/2019;00:00;136;47;89;Leicht bewölkt;7;7;0
08/09/2019;01:00;72;21;51;Leicht bewölkt;7;7;0
08/09/2019;02:00;64;18;46;Leicht bewölkt;7;7;0
08/09/2019;03:00;35;11;24;Leicht bewölkt;7;7;0
08/09/2019;04:00;12;1;11;Leicht bewölkt;8;7;0
08/09/2019;05:00;29;17;12;Leicht bewölkt;8;8;0
08/09/2019;06:00;32;24;8;Leicht bewölkt;9;8;0
08/09/2019;07:00;23;13;10;Leicht bewölkt;9;9;0
08/09/2019;08:00;46;20;26;Nieselregen;10;9;0
08/09/2019;09:00;90;48;42;Nieselregen;10;10;0
08/09/2019;10:00;88;51;37;Nieselregen;10;10;0
08/09/2019;11:00;120;59;61;Leichter Regenfall;11;10;0
08/09/2019;12:00;125;54;71;Leichter Regenfall;11;11;0
08/09/2019;13:00;153;54;99;Leichter Regenfall;11;11;0
08/09/2019;14:00;233;112;121;Stellenweiser leichter Regenfall;12;12;0
08/09/2019;15:00;177;88;89;Stellenweiser leichter Regenfall;13;13;0
08/09/2019;16:00;146;77;69;Stellenweiser leichter Regenfall;12;12;0
08/09/2019;17:00;191;101;90;Stellenweiser Regenfall;12;12;0
08/09/2019;18:00;149;71;78;Stellenweiser Regenfall;11;11;0
08/09/2019;19:00;168;71;97;Stellenweiser Regenfall;11;11;0
08/09/2019;20:00;108;43;65;Leicht bewölkt;10;10;0
08/09/2019;21:00;73;32;41;Leicht bewölkt;10;10;0
08/09/2019;22:00;77;47;30;Leicht bewölkt;9;9;0
08/09/2019;23:00;60;25;35;Leichter Regenschauer;9;8;0
09/09/2019;00:00;23;12;11;Leichter Regenschauer;9;8;0
09/09/2019;01:00;17;5;12;Leichter Regenschauer;9;8;0
09/09/2019;02:00;10;5;5;Leichter Nebel;9;8;0
09/09/2019;03:00;1;1;0;Leichter Nebel;9;8;0
09/09/2019;04:00;7;5;2;Leichter Nebel;9;8;0
09/09/2019;05:00;45;30;15;Leichter Regenfall;9;8;0
09/09/2019;06:00;176;120;56;Leichter Regenfall;10;8;0
09/09/2019;07:00;472;272;200;Leichter Regenfall;10;8;0
09/09/2019;08:00;604;347;257;Leichter Regenfall;11;9;0
09/09/2019;09:00;498;320;178;Leichter Regenfall;11;10;0
09/09/2019;10:00;552;327;225;Leichter Regenfall;13;11;0
09/09/2019;11:00;634;356;278;Stellenweiser Regenfall;14;13;0
09/09/2019;12:00;693;344;349;Stellenweiser Regenfall;15;15;0
09/09/2019;13:00;712;386;326;Stellenweiser Regenfall;16;15;0
09/09/2019;14:00;776;418;358;Leicht bewölkt;16;16;0
09/09/2019;15:00;819;434;385;Leicht bewölkt;17;17;0
09/09/2019;16:00;1008;504;504;Leicht bewölkt;16;16;0
09/09/2019;17:00;1065;455;610;Leicht bewölkt;16;16;0
09/09/2019;18:00;945;428;517;Leicht bewölkt;16;16;0
09/09/2019;19:00;685;306;379;Leicht bewölkt;14;14;0
09/09/2019;20:00;504;221;283;Leicht bewölkt;13;13;0
09/09/2019;21:00;309;146;163;Leicht bewölkt;12;12;0
09/09/2019;22:00;227;73;154;Leicht bewölkt;11;11;0
09/09/2019;23:00;140;40;100;Bewölkt;10;10;0
10/09/2019;00:00;60;11;49;Bewölkt;9;9;0
10/09/2019;01:00;29;9;20;Bewölkt;8;8;0
10/09/2019;02:00;23;12;11;Leicht bewölkt;8;8;0
10/09/2019;03:00;5;1;4;Leicht bewölkt;8;8;0
10/09/2019;04:00;14;7;7;Leicht bewölkt;8;8;0
10/09/2019;05:00;69;58;11;Leicht bewölkt;8;8;0
10/09/2019;06:00;242;165;77;Leicht bewölkt;9;8;0
10/09/2019;07:00;597;364;233;Leicht bewölkt;10;10;0
10/09/2019;08:00;929;541;388;Leicht bewölkt;12;12;0
10/09/2019;09:00;736;463;273;Leicht bewölkt;13;13;0
10/09/2019;10:00;764;454;310;Leicht bewölkt;15;15;0
10/09/2019;11:00;785;406;379;Leicht bewölkt;16;16;0
10/09/2019;12:00;922;440;482;Leicht bewölkt;18;18;0
10/09/2019;13:00;868;416;452;Leicht bewölkt;18;18;0
10/09/2019;14:00;987;529;458;Leicht bewölkt;19;19;0
10/09/2019;15:00;1077;538;539;Leicht bewölkt;19;19;0
10/09/2019;16:00;1185;577;608;Leicht bewölkt;18;18;0
10/09/2019;17:00;1327;613;714;Leicht bewölkt;17;17;0
10/09/2019;18:00;1162;493;669;Leicht bewölkt;16;16;0
10/09/2019;19:00;874;381;493;Leicht bewölkt;15;14;0
10/09/2019;20:00;536;211;325;Leicht bewölkt;13;13;0
10/09/2019;21:00;333;124;209;Leicht bewölkt;12;11;0
10/09/2019;22:00;264;93;171;Leicht bewölkt;11;11;0
10/09/2019;23:00;139;54;85;Leicht bewölkt;10;10;0
11/09/2019;00:00;47;15;32;Leicht bewölkt;10;9;0
11/09/2019;01:00;37;14;23;Leicht bewölkt;9;9;0
11/09/2019;02:00;19;8;11;Leicht bewölkt;9;9;0
11/09/2019;03:00;12;5;7;Leicht bewölkt;9;9;0
11/09/2019;04:00;11;7;4;Leicht bewölkt;9;9;0
11/09/2019;05:00;63;47;16;Leichter Nebel;9;9;0
11/09/2019;06:00;261;181;80;Leichter Nebel;9;9;0
11/09/2019;07:00;768;444;324;Leichter Nebel;11;11;0
11/09/2019;08:00;1152;651;501;Bewölkt;12;12;0
11/09/2019;09:00;1172;830;342;Bewölkt;13;13;0
11/09/2019;10:00;711;410;301;Bewölkt;15;15;0
11/09/2019;11:00;878;444;434;Bewölkt;17;17;0
11/09/2019;12:00;1238;462;776;Bewölkt;19;19;0
11/09/2019;13:00;1172;535;637;Bewölkt;19;19;0
11/09/2019;14:00;1040;551;489;Leicht bewölkt;20;20;0
11/09/2019;15:00;1153;552;601;Leicht bewölkt;21;21;0
11/09/2019;16:00;1325;621;704;Leicht bewölkt;20;20;0
11/09/2019;17:00;1467;696;771;Stellenweiser Regenfall;19;19;0
11/09/2019;18:00;1193;563;630;Stellenweiser Regenfall;18;18;0
11/09/2019;19:00;785;360;425;Stellenweiser Regenfall;17;17;0
11/09/2019;20:00;533;221;312;Leichter Regenschauer;16;16;0
11/09/2019;21:00;346;147;199;Leichter Regenschauer;15;15;0
11/09/2019;22:00;287;107;180;Leichter Regenschauer;14;14;0
11/09/2019;23:00;161;51;110;Leicht bewölkt;13;13;0
12/09/2019;00:00;83;28;55;Leicht bewölkt;12;12;0
12/09/2019;01:00;35;11;24;Leicht bewölkt;12;12;0
12/09/2019;02:00;16;9;7;Leicht bewölkt;12;12;0
12/09/2019;03:00;13;7;6;Leicht bewölkt;12;12;0
12/09/2019;04:00;6;4;2;Leicht bewölkt;12;12;0
12/09/2019;05:00;65;49;16;Leicht bewölkt;12;12;0
12/09/2019;06:00;245;163;82;Leicht bewölkt;12;12;0
12/09/2019;07:00;1290;836;454;Leicht bewölkt;14;14;0
12/09/2019;08:00;1038;606;432;Leicht bewölkt;15;15;0
12/09/2019;09:00;889;543;346;Leicht bewölkt;17;17;0
12/09/2019;10:00;741;421;320;Leicht bewölkt;19;19;0
12/09/2019;11:00;774;365;409;Leicht bewölkt;20;20;0
12/09/2019;12:00;941;471;470;Leicht bewölkt;22;23;0
12/09/2019;13:00;1361;583;778;Leicht bewölkt;22;24;0
12/09/2019;14:00;1188;588;600;Leicht bewölkt;23;24;0
12/09/2019;15:00;1352;681;671;Leicht bewölkt;23;25;0
12/09/2019;16:00;1390;692;698;Leicht bewölkt;23;24;0
12/09/2019;17:00;1498;634;864;Leicht bewölkt;22;22;0
12/09/2019;18:00;1279;597;682;Leicht bewölkt;21;21;0
12/09/2019;19:00;957;431;526;Leicht bewölkt;20;20;0
12/09/2019;20:00;581;245;336;Leicht bewölkt;19;19;0
12/09/2019;21:00;373;152;221;Leicht bewölkt;18;18;0
12/09/2019;22:00;300;110;190;Leicht bewölkt;17;17;0
12/09/2019;23:00;181;52;129;Leicht bewölkt;15;15;0
13/09/2019;00:00;73;18;55;Leicht bewölkt;14;14;0
13/09/2019;01:00;52;11;41;Leicht bewölkt;14;14;0
13/09/2019;02:00;20;7;13;Leicht bewölkt;13;13;0
13/09/2019;03:00;13;5;8;Leicht bewölkt;12;12;0
13/09/2019;04:00;7;5;2;Leicht bewölkt;13;13;0
13/09/2019;05:00;64;47;17;Leicht bewölkt;13;13;0
13/09/2019;06:00;226;149;77;Leicht bewölkt;14;14;0
13/09/2019;07:00;1123;676;447;Leicht bewölkt;16;16;0
13/09/2019;08:00;908;572;336;Sonnig;18;18;0
13/09/2019;09:00;1002;683;319;Sonnig;20;20;0
13/09/2019;10:00;903;514;389;Sonnig;21;21;0
13/09/2019;11:00;1061;546;515;Sonnig;23;24;0
13/09/2019;12:00;1252;595;657;Sonnig;24;26;0
13/09/2019;13:00;1442;567;875;Sonnig;24;26;0
13/09/2019;14:00;1072;556;516;Leicht bewölkt;24;26;0
13/09/2019;15:00;1134;606;528;Leicht bewölkt;24;26;0
13/09/2019;16:00;1237;617;620;Leicht bewölkt;23;25;0
13/09/2019;17:00;1177;519;658;Leicht bewölkt;22;22;0
13/09/2019;18:00;1023;444;579;Leicht bewölkt;21;21;0
13/09/2019;19:00;884;433;451;Leicht bewölkt;20;20;0
13/09/2019;20:00;701;326;375;Leicht bewölkt;19;19;0
13/09/2019;21:00;409;179;230;Leicht bewölkt;18;18;0
13/09/2019;22:00;362;160;202;Leicht bewölkt;17;17;0
13/09/2019;23:00;257;80;177;Leichter Nebel;16;16;0
14/09/2019;00:00;187;49;138;Leichter Nebel;15;15;0
14/09/2019;01:00;103;24;79;Leichter Nebel;14;14;0
14/09/2019;02:00;57;25;32;Leichter Nebel;14;14;0
14/09/2019;03:00;47;8;39;Leichter Nebel;13;13;0
14/09/2019;04:00;26;15;11;Leichter Nebel;14;14;0
14/09/2019;05:00;37;22;15;Leichter Nebel;14;14;0
14/09/2019;06:00;68;42;26;Leichter Nebel;14;15;0
14/09/2019;07:00;134;75;59;Leichter Nebel;16;16;0
14/09/2019;08:00;326;194;132;Leichter Nebel;17;17;0
14/09/2019;09:00;599;377;222;Leichter Nebel;19;19;0
14/09/2019;10:00;869;539;330;Leichter Nebel;20;20;0
14/09/2019;11:00;1058;633;425;Leicht bewölkt;21;21;0
14/09/2019;12:00;1029;507;522;Leicht bewölkt;23;24;0
14/09/2019;13:00;1028;490;538;Leicht bewölkt;23;24;0
14/09/2019;14:00;1061;464;597;Leicht bewölkt;23;25;0
14/09/2019;15:00;1011;443;568;Leicht bewölkt;23;25;0
14/09/2019;16:00;996;481;515;Leicht bewölkt;22;25;0
14/09/2019;17:00;1030;492;538;Leicht bewölkt;22;22;0
14/09/2019;18:00;922;494;428;Leicht bewölkt;21;21;0
14/09/2019;19:00;685;329;356;Leicht bewölkt;20;20;0
14/09/2019;20:00;516;241;275;Leicht bewölkt;19;19;0
14/09/2019;21:00;403;208;195;Leicht bewölkt;18;18;0
14/09/2019;22:00;253;99;154;Leicht bewölkt;17;17;0
14/09/2019;23:00;238;90;148;Leichter Nebel;16;16;0
15/09/2019;00:00;186;65;121;Leichter Nebel;15;15;0
15/09/2019;01:00;115;44;71;Leichter Nebel;14;15;0
15/09/2019;02:00;73;30;43;Leichter Nebel;14;14;0
15/09/2019;03:00;49;19;30;Leichter Nebel;13;13;0
15/09/2019;04:00;31;16;15;Leichter Nebel;13;14;0
15/09/2019;05:00;29;17;12;Nebel;14;14;0
15/09/2019;06:00;46;32;14;Nebel;14;14;0
15/09/2019;07:00;71;52;19;Nebel;15;15;0
15/09/2019;08:00;129;65;64;Leichter Nebel;17;17;0
15/09/2019;09:00;356;182;174;Leichter Nebel;18;18;0
15/09/2019;10:00;462;238;224;Leichter Nebel;20;20;0
15/09/2019;11:00;628;334;294;Leicht bewölkt;22;23;0
15/09/2019;12:00;690;338;352;Leicht bewölkt;24;25;0
15/09/2019;13:00;715;333;382;Leicht bewölkt;25;26;0
15/09/2019;14:00;898;453;445;Sonnig;26;27;0
15/09/2019;15:00;968;480;488;Sonnig;27;29;0
15/09/2019;16:00;877;497;380;Sonnig;27;29;0
15/09/2019;17:00;977;483;494;Sonnig;26;29;0
15/09/2019;18:00;769;378;391;Sonnig;26;29;0
15/09/2019;19:00;569;280;289;Sonnig;25;28;0
15/09/2019;20:00;409;197;212;Leicht bewölkt;24;28;0
15/09/2019;21:00;192;70;122;Leicht bewölkt;23;27;0
15/09/2019;22:00;159;77;82;Leicht bewölkt;21;21;0
15/09/2019;23:00;77;25;52;Leicht bewölkt;19;19;0
16/09/2019;00:00;38;7;31;Leicht bewölkt;17;17;0
16/09/2019;01:00;23;4;19;Leicht bewölkt;16;16;0
16/09/2019;02:00;17;9;8;Leicht bewölkt;15;15;0
16/09/2019;03:00;8;3;5;Leicht bewölkt;15;15;0
16/09/2019;04:00;11;9;2;Leicht bewölkt;10;15;0
16/09/2019;05:00;73;49;24;Leicht bewölkt;5;15;0
16/09/2019;06:00;214;140;74;Leicht bewölkt;0;15;0
16/09/2019;07:00;1284;838;446;Leicht bewölkt;0;17;0
16/09/2019;08:00;992;591;401;Leicht bewölkt;0;18;0
16/09/2019;09:00;894;569;325;Leicht bewölkt;0;20;0
16/09/2019;10:00;677;382;295;Leicht bewölkt;0;21;0
16/09/2019;11:00;857;444;413;Leicht bewölkt;0;23;0
16/09/2019;12:00;968;431;537;Leicht bewölkt;0;24;0
16/09/2019;13:00;1339;587;752;Leicht bewölkt;0;25;0
16/09/2019;14:00;1016;490;526;Leicht bewölkt;0;25;0
16/09/2019;15:00;1548;788;760;Leicht bewölkt;0;26;0
16/09/2019;16:00;1336;617;719;Leicht bewölkt;0;24;0
16/09/2019;17:00;1403;657;746;Leichter Eisregen;0;22;0
16/09/2019;18:00;1265;564;701;Leichter Eisregen;0;21;0
16/09/2019;19:00;952;424;528;Leichter Eisregen;-1;15;0
16/09/2019;20:00;607;248;359;Stellenweiser Regenfall;-2;9;0
16/09/2019;21:00;346;139;207;Stellenweiser Regenfall;-3;3;0
16/09/2019;22:00;263;115;148;Stellenweiser Regenfall;1;5;0
16/09/2019;23:00;130;48;82;Leichter Eisregen;5;7;0
17/09/2019;00:00;45;14;31;Leichter Eisregen;8;8;0
17/09/2019;01:00;29;6;23;Leichter Eisregen;10;10;0
17/09/2019;02:00;17;6;11;Stellenweiser Regenfall;13;13;0
17/09/2019;03:00;3;3;0;Stellenweiser Regenfall;15;15;0
17/09/2019;04:00;12;9;3;Stellenweiser Regenfall;15;15;0
17/09/2019;05:00;87;65;22;Leicht bewölkt;15;15;0
17/09/2019;06:00;250;172;78;Leicht bewölkt;15;15;0
17/09/2019;07:00;1366;841;525;Leicht bewölkt;16;16;0
17/09/2019;08:00;1023;614;409;Leicht bewölkt;17;17;0
17/09/2019;09:00;949;603;346;Leicht bewölkt;19;19;0
17/09/2019;10:00;797;458;339;Leicht bewölkt;20;20;0
17/09/2019;11:00;962;484;478;Leicht bewölkt;21;21;0
17/09/2019;12:00;1015;470;545;Leicht bewölkt;22;24;0
17/09/2019;13:00;1317;599;718;Leicht bewölkt;22;23;0
17/09/2019;14:00;920;442;478;Leicht bewölkt;22;22;0
17/09/2019;15:00;1446;670;776;Leicht bewölkt;22;22;0
17/09/2019;16:00;1309;640;669;Leicht bewölkt;21;21;0
17/09/2019;17:00;1519;705;814;Stellenweiser Regenfall;20;20;0
17/09/2019;18:00;1258;534;724;Stellenweiser Regenfall;19;19;0
17/09/2019;19:00;1033;507;526;Stellenweiser Regenfall;17;17;0
17/09/2019;20:00;603;290;313;Leichter Regenschauer;16;16;0
17/09/2019;21:00;384;139;245;Leichter Regenschauer;15;14;0
17/09/2019;22:00;245;72;173;Leichter Regenschauer;14;13;0
17/09/2019;23:00;200;75;125;Stellenweiser Nieselregen;13;11;0
18/09/2019;00:00;64;23;41;Stellenweiser Nieselregen;12;10;0
18/09/2019;01:00;35;11;24;Stellenweiser Nieselregen;11;9;0
18/09/2019;02:00;15;10;5;Stellenweiser Nieselregen;11;9;0
18/09/2019;03:00;1;0;1;Stellenweiser Nieselregen;10;8;0
18/09/2019;04:00;19;15;4;Stellenweiser Nieselregen;10;8;0
18/09/2019;05:00;74;48;26;Leicht bewölkt;10;8;0
18/09/2019;06:00;276;175;101;Leicht bewölkt;10;7;0
18/09/2019;07:00;1374;888;486;Leicht bewölkt;11;9;0
18/09/2019;08:00;1073;640;433;Leicht bewölkt;12;10;0
18/09/2019;09:00;920;590;330;Leicht bewölkt;13;11;0
18/09/2019;10:00;700;389;311;Leicht bewölkt;14;12;0
18/09/2019;11:00;764;385;379;Leicht bewölkt;15;14;0
18/09/2019;12:00;956;453;503;Leicht bewölkt;16;16;0
18/09/2019;13:00;1293;631;662;Leicht bewölkt;16;16;0
18/09/2019;14:00;1021;517;504;Leicht bewölkt;16;16;0
18/09/2019;15:00;1318;584;734;Leicht bewölkt;16;16;0
18/09/2019;16:00;1215;587;628;Leicht bewölkt;16;16;0
18/09/2019;17:00;1398;648;750;Leicht bewölkt;15;15;0
18/09/2019;18:00;1179;531;648;Leicht bewölkt;15;15;0
18/09/2019;19:00;868;404;464;Leicht bewölkt;14;14;0
18/09/2019;20:00;555;242;313;Leicht bewölkt;13;13;0
18/09/2019;21:00;365;145;220;Leicht bewölkt;12;12;0
18/09/2019;22:00;282;124;158;Leicht bewölkt;11;10;0
18/09/2019;23:00;176;64;112;Leicht bewölkt;9;8;0
19/09/2019;00:00;89;24;65;Leicht bewölkt;8;6;0
19/09/2019;01:00;33;9;24;Leicht bewölkt;7;5;0
19/09/2019;02:00;5;1;4;Sonnig;7;5;0
19/09/2019;03:00;9;6;3;Sonnig;6;4;0
19/09/2019;04:00;9;6;3;Sonnig;6;4;0
19/09/2019;05:00;66;46;20;Sonnig;6;4;0
19/09/2019;06:00;247;163;84;Sonnig;7;4;0
19/09/2019;07:00;1319;842;477;Sonnig;8;6;0
19/09/2019;08:00;925;543;382;Bedeckt;10;8;0
19/09/2019;09:00;820;515;305;Bedeckt;11;10;0
19/09/2019;10:00;716;429;287;Bedeckt;13;11;0
19/09/2019;11:00;788;412;376;Leicht bewölkt;14;13;0
19/09/2019;12:00;903;458;445;Leicht bewölkt;15;15;0
19/09/2019;13:00;1228;520;708;Leicht bewölkt;15;15;0
19/09/2019;14:00;952;474;478;Sonnig;16;15;0
19/09/2019;15:00;1413;668;745;Sonnig;16;16;0
19/09/2019;16:00;1298;653;645;Sonnig;15;15;0
19/09/2019;17:00;1441;690;751;Sonnig;14;14;0
19/09/2019;18:00;1198;583;615;Sonnig;13;13;0
19/09/2019;19:00;852;378;474;Sonnig;11;11;0
19/09/2019;20:00;556;242;314;Leicht bewölkt;10;9;0
19/09/2019;21:00;392;141;251;Leicht bewölkt;9;7;0
19/09/2019;22:00;286;96;190;Leicht bewölkt;8;6;0
19/09/2019;23:00;144;43;101;Sonnig;7;5;0
20/09/2019;00:00;103;27;76;Sonnig;6;3;0
20/09/2019;01:00;39;15;24;Sonnig;6;3;0
20/09/2019;02:00;24;6;18;Sonnig;6;3;0
20/09/2019;03:00;8;5;3;Sonnig;5;3;0
20/09/2019;04:00;8;3;5;Sonnig;5;3;0
20/09/2019;05:00;59;41;18;Leicht bewölkt;5;3;0
20/09/2019;06:00;218;143;75;Leicht bewölkt;5;3;0
20/09/2019;07:00;1234;762;472;Leicht bewölkt;6;5;0
20/09/2019;08:00;942;572;370;Leicht bewölkt;8;7;0
20/09/2019;09:00;855;570;285;Leicht bewölkt;10;9;0
20/09/2019;10:00;805;474;331;Leicht bewölkt;12;11;0
20/09/2019;11:00;644;388;256;Leicht bewölkt;13;13;0
20/09/2019;12:00;1217;636;581;Leicht bewölkt;15;15;0
20/09/2019;13:00;1426;528;898;Leicht bewölkt;15;15;0
20/09/2019;14:00;1151;526;625;Leicht bewölkt;16;16;0
20/09/2019;15:00;1020;513;507;Leicht bewölkt;16;16;0
20/09/2019;16:00;1168;593;575;Leicht bewölkt;15;15;0
20/09/2019;17:00;1101;566;535;Leicht bewölkt;14;14;0
20/09/2019;18:00;1081;511;570;Leicht bewölkt;13;13;0
20/09/2019;19:00;835;428;407;Leicht bewölkt;12;12;0
20/09/2019;20:00;560;233;327;Leicht bewölkt;10;10;0
20/09/2019;21:00;389;170;219;Leicht bewölkt;9;9;0
20/09/2019;22:00;312;98;214;Leicht bewölkt;8;7;0
20/09/2019;23:00;274;66;208;Leicht bewölkt;7;6;0
21/09/2019;00:00;188;42;146;Leicht bewölkt;6;5;0
21/09/2019;01:00;119;30;89;Leicht bewölkt;6;5;0
21/09/2019;02:00;65;34;31;Leicht bewölkt;5;5;0
21/09/2019;03:00;31;10;21;Leicht bewölkt;5;5;0
21/09/2019;04:00;40;18;22;Leicht bewölkt;5;5;0
21/09/2019;05:00;34;19;15;Leichter Nebel;6;5;0
21/09/2019;06:00;62;46;16;Leichter Nebel;6;6;0
21/09/2019;07:00;122;72;50;Leichter Nebel;8;8;0
21/09/2019;08:00;274;162;112;Leicht bewölkt;11;11;0
21/09/2019;09:00;543;344;199;Leicht bewölkt;13;13;0
21/09/2019;10:00;823;502;321;Leicht bewölkt;15;15;0
21/09/2019;11:00;949;578;371;Sonnig;18;18;0
21/09/2019;12:00;951;513;438;Sonnig;20;20;0
21/09/2019;13:00;967;495;472;Sonnig;20;20;0
21/09/2019;14:00;984;482;502;Sonnig;21;21;0
21/09/2019;15:00;953;454;499;Sonnig;21;21;0
21/09/2019;16:00;955;478;477;Sonnig;20;20;0
21/09/2019;17:00;936;437;499;Sonnig;19;19;0
21/09/2019;18:00;801;373;428;Sonnig;18;18;0
21/09/2019;19:00;668;359;309;Sonnig;17;17;0
21/09/2019;20:00;437;224;213;Leicht bewölkt;17;17;0
21/09/2019;21:00;366;130;236;Leicht bewölkt;16;16;0
21/09/2019;22:00;243;76;167;Leicht bewölkt;15;15;0
21/09/2019;23:00;184;52;132;Leicht bewölkt;13;13;0
22/09/2019;00:00;171;53;118;Leicht bewölkt;12;12;0
22/09/2019;01:00;129;35;94;Leicht bewölkt;12;12;0
22/09/2019;02:00;63;23;40;Leicht bewölkt;11;11;0
22/09/2019;03:00;64;29;35;Leicht bewölkt;11;11;0
22/09/2019;04:00;15;8;7;Leicht bewölkt;11;11;0
22/09/2019;05:00;20;7;13;Leicht bewölkt;11;11;0
22/09/2019;06:00;41;24;17;Leicht bewölkt;12;12;0
22/09/2019;07:00;48;32;16;Leicht bewölkt;13;13;0
22/09/2019;08:00;127;65;62;Leicht bewölkt;15;15;0
22/09/2019;09:00;295;158;137;Leicht bewölkt;17;17;0
22/09/2019;10:00;340;184;156;Leicht bewölkt;18;18;0
22/09/2019;11:00;512;257;255;Leicht bewölkt;20;20;0
22/09/2019;12:00;500;233;267;Leicht bewölkt;22;22;0
22/09/2019;13:00;541;255;286;Leicht bewölkt;22;22;0
22/09/2019;14:00;631;350;281;Leicht bewölkt;22;24;0
22/09/2019;15:00;669;356;313;Leicht bewölkt;23;25;0
22/09/2019;16:00;634;335;299;Leicht bewölkt;22;22;0
22/09/2019;17:00;652;320;332;Stellenweiser Regenfall;21;21;0
22/09/2019;18:00;631;304;327;Stellenweiser Regenfall;21;21;0
22/09/2019;19:00;469;213;256;Stellenweiser Regenfall;20;20;0
22/09/2019;20:00;272;114;158;Stellenweiser Regenfall;19;19;0
22/09/2019;21:00;158;71;87;Stellenweiser Regenfall;18;18;0
22/09/2019;22:00;131;42;89;Stellenweiser Regenfall;17;17;0
22/09/2019;23:00;57;17;40;Leicht bewölkt;15;15;0
23/09/2019;00:00;36;14;22;Leicht bewölkt;14;13;0
23/09/2019;01:00;11;4;7;Leicht bewölkt;13;13;0
23/09/2019;02:00;5;4;1;Bedeckt;13;12;0
23/09/2019;03:00;6;2;4;Bedeckt;12;11;0
23/09/2019;04:00;8;6;2;Bedeckt;12;11;0
23/09/2019;05:00;53;38;15;Leichter Regenfall;12;12;0
23/09/2019;06:00;185;112;73;Leichter Regenfall;13;12;0
23/09/2019;07:00;884;579;305;Leichter Regenfall;13;12;0
23/09/2019;08:00;650;380;270;Mäßiger Regenfall;13;12;0
23/09/2019;09:00;434;265;169;Mäßiger Regenfall;13;13;0
23/09/2019;10:00;205;108;97;Mäßiger Regenfall;13;13;0
23/09/2019;11:00;291;118;173;Teilweise mäßiger Regenfall;14;14;0
23/09/2019;12:00;324;152;172;Teilweise mäßiger Regenfall;14;14;0
23/09/2019;13:00;633;272;361;Teilweise mäßiger Regenfall;15;15;0
23/09/2019;14:00;534;273;261;Leicht bewölkt;16;16;0
23/09/2019;15:00;834;427;407;Leicht bewölkt;17;17;0
23/09/2019;16:00;919;498;421;Leicht bewölkt;16;16;0
23/09/2019;17:00;1028;508;520;Stellenweiser Regenfall;15;15;0
23/09/2019;18:00;917;437;480;Stellenweiser Regenfall;14;15;0
23/09/2019;19:00;634;290;344;Stellenweiser Regenfall;13;13;0
23/09/2019;20:00;418;198;220;Leicht bewölkt;12;12;0
23/09/2019;21:00;263;112;151;Leicht bewölkt;11;11;0
23/09/2019;22:00;216;81;135;Leicht bewölkt;10;10;0
23/09/2019;23:00;112;35;77;Stellenweiser Regenfall;9;10;0
24/09/2019;00:00;50;18;32;Stellenweiser Regenfall;9;9;0
24/09/2019;01:00;27;5;22;Stellenweiser Regenfall;9;9;0
24/09/2019;02:00;17;7;10;Stellenweiser Regenfall;8;8;0
24/09/2019;03:00;7;1;6;Stellenweiser Regenfall;8;8;0
24/09/2019;04:00;3;2;1;Stellenweiser Regenfall;8;8;0
24/09/2019;05:00;66;51;15;Leicht bewölkt;8;8;0
24/09/2019;06:00;252;160;92;Leicht bewölkt;8;8;0
24/09/2019;07:00;1142;749;393;Leicht bewölkt;10;10;0
24/09/2019;08:00;974;596;378;Leicht bewölkt;12;12;0
24/09/2019;09:00;836;500;336;Leicht bewölkt;14;14;0
24/09/2019;10:00;646;339;307;Leicht bewölkt;15;15;0
24/09/2019;11:00;725;353;372;Leicht bewölkt;16;16;0
24/09/2019;12:00;775;357;418;Leicht bewölkt;17;17;0
24/09/2019;13:00;1061;460;601;Leicht bewölkt;17;17;0
24/09/2019;14:00;815;417;398;Leicht bewölkt;17;17;0
24/09/2019;15:00;1050;485;565;Leicht bewölkt;17;17;0
24/09/2019;16:00;1091;532;559;Leicht bewölkt;16;16;0
24/09/2019;17:00;1156;542;614;Leicht bewölkt;15;15;0
24/09/2019;18:00;914;373;541;Leicht bewölkt;13;13;0
24/09/2019;19:00;706;309;397;Leicht bewölkt;12;12;0
24/09/2019;20:00;383;148;235;Leichter Regenfall;11;11;0
24/09/2019;21:00;281;132;149;Leichter Regenfall;9;9;0
24/09/2019;22:00;220;80;140;Leichter Regenfall;10;10;0
24/09/2019;23:00;109;35;74;Stellenweiser leichter Regenfall;10;10;0
25/09/2019;00:00;59;21;38;Stellenweiser leichter Regenfall;11;10;0
25/09/2019;01:00;23;8;15;Stellenweiser leichter Regenfall;11;11;0
25/09/2019;02:00;15;3;12;Leichter Regenschauer;11;11;0
25/09/2019;03:00;7;4;3;Leichter Regenschauer;12;11;0
25/09/2019;04:00;9;6;3;Leichter Regenschauer;12;11;0
25/09/2019;05:00;75;55;20;Leichter Regenschauer;12;11;0
25/09/2019;06:00;235;151;84;Leichter Regenschauer;12;11;0
25/09/2019;07:00;1135;724;411;Leichter Regenschauer;13;12;0
25/09/2019;08:00;948;584;364;Leichter Regenschauer;13;12;0
25/09/2019;09:00;754;477;277;Leichter Regenschauer;14;13;0
25/09/2019;10:00;594;332;262;Leichter Regenschauer;14;14;0
25/09/2019;11:00;672;346;326;Bewölkt;15;15;0
25/09/2019;12:00;791;328;463;Bewölkt;16;15;0
25/09/2019;13:00;944;437;507;Bewölkt;16;16;0
25/09/2019;14:00;759;390;369;Leicht bewölkt;16;16;0
25/09/2019;15:00;1021;468;553;Leicht bewölkt;16;16;0
25/09/2019;16:00;993;503;490;Leicht bewölkt;15;15;0
25/09/2019;17:00;1116;515;601;Leichter Regenschauer;14;14;0
25/09/2019;18:00;942;432;510;Leichter Regenschauer;14;14;0
25/09/2019;19:00;645;326;319;Leichter Regenschauer;13;13;0
25/09/2019;20:00;461;213;248;Mäßiger bis starker Regenschauer;12;12;0
25/09/2019;21:00;327;128;199;Mäßiger bis starker Regenschauer;12;12;0
25/09/2019;22:00;265;75;190;Mäßiger bis starker Regenschauer;12;11;0
25/09/2019;23:00;182;58;124;Stellenweiser leichter Regenfall;11;11;0
26/09/2019;00:00;77;22;55;Stellenweiser leichter Regenfall;11;11;0
26/09/2019;01:00;61;10;51;Stellenweiser leichter Regenfall;11;11;0
26/09/2019;02:00;16;5;11;Leichter Regenfall;11;11;0
26/09/2019;03:00;6;3;3;Leichter Regenfall;11;11;0
26/09/2019;04:00;9;6;3;Leichter Regenfall;11;11;0
26/09/2019;05:00;64;50;14;Nieselregen;11;10;0
26/09/2019;06:00;203;129;74;Nieselregen;11;10;0
26/09/2019;07:00;967;599;368;Nieselregen;11;10;0
26/09/2019;08:00;768;462;306;Mäßiger Regenfall;11;11;0
26/09/2019;09:00;541;348;193;Mäßiger Regenfall;12;11;0
26/09/2019;10:00;424;232;192;Mäßiger Regenfall;12;11;0
26/09/2019;11:00;493;273;220;Mäßiger Regenfall;12;12;0
26/09/2019;12:00;586;264;322;Mäßiger Regenfall;13;12;0
26/09/2019;13:00;833;355;478;Mäßiger Regenfall;13;12;0
26/09/2019;14:00;604;304;300;Mäßiger Regenfall;13;13;0
26/09/2019;15:00;984;533;451;Mäßiger Regenfall;14;13;0
26/09/2019;16:00;970;499;471;Mäßiger Regenfall;14;13;0
26/09/2019;17:00;1118;532;586;Leichter Regenfall;14;14;0
26/09/2019;18:00;955;448;507;Leichter Regenfall;14;14;0
26/09/2019;19:00;635;324;311;Leichter Regenfall;14;14;0
26/09/2019;20:00;437;226;211;Bedeckt;13;13;0
26/09/2019;21:00;284;120;164;Bedeckt;13;13;0
26/09/2019;22:00;285;99;186;Bedeckt;13;13;0
26/09/2019;23:00;192;50;142;Bedeckt;13;13;0
27/09/2019;00:00;90;24;66;Bedeckt;12;13;0
27/09/2019;01:00;51;13;38;Bedeckt;12;12;0
27/09/2019;02:00;18;7;11;Bedeckt;12;12;0
27/09/2019;03:00;8;5;3;Bedeckt;12;11;0
27/09/2019;04:00;8;6;2;Bedeckt;12;11;0
27/09/2019;05:00;72;51;21;Leicht bewölkt;12;11;0
27/09/2019;06:00;197;132;65;Leicht bewölkt;12;12;0
27/09/2019;07:00;1055;642;413;Leicht bewölkt;13;13;0
27/09/2019;08:00;899;542;357;Bewölkt;14;14;0
27/09/2019;09:00;778;503;275;Bewölkt;16;16;0
27/09/2019;10:00;686;419;267;Bewölkt;17;17;0
27/09/2019;11:00;791;432;359;Bewölkt;18;18;0
27/09/2019;12:00;1004;460;544;Bewölkt;20;20;0
27/09/2019;13:00;1197;510;687;Bewölkt;20;20;0
27/09/2019;14:00;957;493;464;Leicht bewölkt;20;20;0
27/09/2019;15:00;1149;614;535;Leicht bewölkt;21;21;0
27/09/2019;16:00;1063;508;555;Leicht bewölkt;20;20;0
27/09/2019;17:00;1057;514;543;Stellenweiser Regenfall;19;19;0
27/09/2019;18:00;928;453;475;Stellenweiser Regenfall;19;19;0
27/09/2019;19:00;669;303;366;Stellenweiser Regenfall;17;17;0
27/09/2019;20:00;467;224;243;Leicht bewölkt;16;16;0
27/09/2019;21:00;333;143;190;Leicht bewölkt;15;15;0
27/09/2019;22:00;263;78;185;Leicht bewölkt;14;14;0
27/09/2019;23:00;238;65;173;Stellenweiser Regenfall;13;13;0
28/09/2019;00:00;141;42;99;Stellenweiser Regenfall;13;13;0
28/09/2019;01:00;80;15;65;Stellenweiser Regenfall;13;12;0
28/09/2019;02:00;54;19;35;Stellenweiser leichter Regenfall;12;11;0
28/09/2019;03:00;22;11;11;Stellenweiser leichter Regenfall;12;11;1
28/09/2019;04:00;17;11;6;Stellenweiser leichter Regenfall;12;11;0
28/09/2019;05:00;27;16;11;Teilweise mäßiger Regenfall;12;11;1
28/09/2019;06:00;61;45;16;Teilweise mäßiger Regenfall;12;11;1
28/09/2019;07:00;98;61;37;Teilweise mäßiger Regenfall;13;11;0
28/09/2019;08:00;251;146;105;Teilweise mäßiger Regenfall;13;12;0
28/09/2019;09:00;485;314;171;Teilweise mäßiger Regenfall;13;12;0
28/09/2019;10:00;623;375;248;Teilweise mäßiger Regenfall;14;13;0
28/09/2019;11:00;780;435;345;Leicht bewölkt;15;15;0
28/09/2019;12:00;771;441;330;Leicht bewölkt;16;16;0
28/09/2019;13:00;825;452;373;Leicht bewölkt;17;16;0
28/09/2019;14:00;836;447;389;Leicht bewölkt;17;17;0
28/09/2019;15:00;845;447;398;Leicht bewölkt;17;17;0
28/09/2019;16:00;844;421;423;Leicht bewölkt;17;17;0
28/09/2019;17:00;875;374;501;Bewölkt;16;16;0
28/09/2019;18:00;763;353;410;Bewölkt;15;15;0
28/09/2019;19:00;593;301;292;Bewölkt;13;13;0
28/09/2019;20:00;423;188;235;Bedeckt;12;12;0
28/09/2019;21:00;284;132;152;Bedeckt;11;11;0
28/09/2019;22:00;217;85;132;Bedeckt;10;10;0
28/09/2019;23:00;205;75;130;Leicht bewölkt;10;10;0
29/09/2019;00:00;180;52;128;Leicht bewölkt;9;9;0
29/09/2019;01:00;125;34;91;Leicht bewölkt;9;9;0
29/09/2019;02:00;77;12;65;Leicht bewölkt;9;9;0
29/09/2019;03:00;58;15;43;Leicht bewölkt;9;9;0
29/09/2019;04:00;24;11;13;Leicht bewölkt;9;9;0
29/09/2019;05:00;24;13;11;Leicht bewölkt;9;10;0
29/09/2019;06:00;41;28;13;Leicht bewölkt;10;10;0
29/09/2019;07:00;57;35;22;Leicht bewölkt;11;11;0
29/09/2019;08:00;109;66;43;Leicht bewölkt;13;13;0
29/09/2019;09:00;294;182;112;Leicht bewölkt;15;15;0
29/09/2019;10:00;500;290;210;Leicht bewölkt;17;17;0
29/09/2019;11:00;571;289;282;Leicht bewölkt;18;18;0
29/09/2019;12:00;668;344;324;Leicht bewölkt;20;20;0
29/09/2019;13:00;721;410;311;Leicht bewölkt;21;21;0
29/09/2019;14:00;795;439;356;Leicht bewölkt;21;21;0
29/09/2019;15:00;943;467;476;Leicht bewölkt;21;21;0
29/09/2019;16:00;867;390;477;Leicht bewölkt;21;21;0
29/09/2019;17:00;764;391;373;Leicht bewölkt;20;20;0
29/09/2019;18:00;684;325;359;Leicht bewölkt;20;20;0
29/09/2019;19:00;486;232;254;Leicht bewölkt;19;19;0
29/09/2019;20:00;312;128;184;Leicht bewölkt;18;18;0
29/09/2019;21:00;161;73;88;Leicht bewölkt;17;17;0
29/09/2019;22:00;154;60;94;Leicht bewölkt;17;17;0
29/09/2019;23:00;73;36;37;Bewölkt;16;16;0
30/09/2019;00:00;37;12;25;Bewölkt;16;16;0
30/09/2019;01:00;32;14;18;Bewölkt;16;16;0
30/09/2019;02:00;7;6;1;Leicht bewölkt;16;16;0
30/09/2019;03:00;5;3;2;Leicht bewölkt;15;15;0
30/09/2019;04:00;13;9;4;Leicht bewölkt;15;15;0
30/09/2019;05:00;72;52;20;Leichter Regenschauer;15;14;0
30/09/2019;06:00;220;145;75;Leichter Regenschauer;15;14;0
30/09/2019;07:00;1213;797;416;Leichter Regenschauer;15;14;0
30/09/2019;08:00;922;551;371;Leicht bewölkt;15;15;0
30/09/2019;09:00;822;491;331;Leicht bewölkt;16;15;0
30/09/2019;10:00;621;347;274;Leicht bewölkt;16;16;0
30/09/2019;11:00;701;353;348;Leicht bewölkt;17;17;0
30/09/2019;12:00;812;402;410;Leicht bewölkt;18;18;0
30/09/2019;13:00;1073;514;559;Leicht bewölkt;18;18;0
30/09/2019;14:00;885;452;433;Leicht bewölkt;18;18;0
30/09/2019;15:00;1192;587;605;Leicht bewölkt;18;18;0
30/09/2019;16:00;1229;590;639;Leicht bewölkt;17;17;0
30/09/2019;17:00;1303;593;710;Leicht bewölkt;16;16;0
30/09/2019;18:00;1053;487;566;Leicht bewölkt;16;16;0
30/09/2019;19:00;774;362;412;Leicht bewölkt;14;14;0
30/09/2019;20:00;515;243;272;Leicht bewölkt;13;13;0
30/09/2019;21:00;351;134;217;Leicht bewölkt;11;12;0
30/09/2019;22:00;263;106;157;Leicht bewölkt;11;11;0
30/09/2019;23:00;159;48;111;Leicht bewölkt;10;10;0
01/10/2019;00:00;67;17;50;Leicht bewölkt;9;10;0
01/10/2019;01:00;32;11;21;Leicht bewölkt;9;9;0
01/10/2019;02:00;10;5;5;Leicht bewölkt;9;9;0
01/10/2019;03:00;3;1;2;Leicht bewölkt;9;9;0
01/10/2019;04:00;13;10;3;Leicht bewölkt;9;9;0
01/10/2019;05:00;63;44;19;Leicht bewölkt;9;9;0
01/10/2019;06:00;235;149;86;Leicht bewölkt;9;9;0
01/10/2019;07:00;1391;939;452;Leicht bewölkt;11;11;0
01/10/2019;08:00;1047;630;417;Leicht bewölkt;13;13;0
01/10/2019;09:00;1031;703;328;Leicht bewölkt;14;14;0
01/10/2019;10:00;780;438;342;Leicht bewölkt;16;16;0
01/10/2019;11:00;1097;525;572;Leicht bewölkt;18;18;0
01/10/2019;12:00;1019;411;608;Leicht bewölkt;20;20;0
01/10/2019;13:00;1237;544;693;Leicht bewölkt;19;19;0
01/10/2019;14:00;1045;526;519;Leicht bewölkt;19;19;0
01/10/2019;15:00;1302;626;676;Leicht bewölkt;19;19;0
01/10/2019;16:00;1325;615;710;Leicht bewölkt;18;18;0
01/10/2019;17:00;1565;736;829;Stellenweiser Regenfall;17;17;0
01/10/2019;18:00;1256;486;770;Stellenweiser Regenfall;16;16;0
01/10/2019;19:00;772;361;411;Stellenweiser Regenfall;15;15;0
01/10/2019;20:00;460;220;240;Leicht bewölkt;14;14;0
01/10/2019;21:00;371;167;204;Leicht bewölkt;13;13;0
01/10/2019;22:00;239;92;147;Leicht bewölkt;13;12;0
01/10/2019;23:00;128;43;85;Mäßiger Regenfall;13;12;1
02/10/2019;00:00;71;20;51;Mäßiger Regenfall;13;12;2
02/10/2019;01:00;41;6;35;Mäßiger Regenfall;13;12;1
02/10/2019;02:00;10;3;7;Starker Regenfall;13;12;1
02/10/2019;03:00;11;4;7;Starker Regenfall;13;12;1
02/10/2019;04:00;12;9;3;Starker Regenfall;13;12;0
02/10/2019;05:00;50;35;15;Mäßiger bis starker Regenschauer;12;11;0
02/10/2019;06:00;198;131;67;Mäßiger bis starker Regenschauer;12;11;1
02/10/2019;07:00;1183;773;410;Mäßiger bis starker Regenschauer;12;11;0
02/10/2019;08:00;974;630;344;Mäßiger bis starker Regenschauer;13;11;0
02/10/2019;09:00;700;449;251;Mäßiger bis starker Regenschauer;13;12;0
02/10/2019;10:00;553;289;264;Mäßiger bis starker Regenschauer;14;12;0
02/10/2019;11:00;774;362;412;Leichter Regenschauer;14;13;0
02/10/2019;12:00;804;358;446;Leichter Regenschauer;15;13;0
02/10/2019;13:00;1065;570;495;Leichter Regenschauer;15;13;0
02/10/2019;14:00;793;413;380;Leichter Regenschauer;15;13;0
02/10/2019;15:00;1080;506;574;Leichter Regenschauer;15;13;0
02/10/2019;16:00;919;402;517;Leichter Regenschauer;14;13;0
02/10/2019;17:00;1035;453;582;Mäßiger bis starker Regenschauer;14;13;0
02/10/2019;18:00;821;345;476;Mäßiger bis starker Regenschauer;13;13;0
02/10/2019;19:00;596;268;328;Mäßiger bis starker Regenschauer;12;12;0
02/10/2019;20:00;473;240;233;Mäßiger bis starker Regenschauer;10;10;0
02/10/2019;21:00;276;146;130;Mäßiger bis starker Regenschauer;9;9;0
02/10/2019;22:00;254;90;164;Mäßiger bis starker Regenschauer;8;8;0
02/10/2019;23:00;171;60;111;Leichter Regenschauer;7;7;0
03/10/2019;00:00;133;36;97;Leichter Regenschauer;6;6;0
03/10/2019;01:00;117;34;83;Leichter Regenschauer;6;6;0
03/10/2019;02:00;60;16;44;Leichter Regenschauer;5;5;0
03/10/2019;03:00;49;16;33;Leichter Regenschauer;5;5;0
03/10/2019;04:00;14;5;9;Leichter Regenschauer;5;5;0
03/10/2019;05:00;33;25;8;Stellenweiser Regenfall;5;5;0
03/10/2019;06:00;81;66;15;Stellenweiser Regenfall;5;5;0
03/10/2019;07:00;112;99;13;Stellenweiser Regenfall;6;6;0
03/10/2019;08:00;177;113;64;Stellenweiser Regenfall;7;7;0
03/10/2019;09:00;237;124;113;Stellenweiser Regenfall;9;9;0
03/10/2019;10:00;331;204;127;Stellenweiser Regenfall;10;11;0
03/10/2019;11:00;415;231;184;Leicht bewölkt;12;12;0
03/10/2019;12:00;459;261;198;Leicht bewölkt;14;14;0
03/10/2019;13:00;491;273;218;Leicht bewölkt;14;14;0
03/10/2019;14:00;601;312;289;Leicht bewölkt;14;15;0
03/10/2019;15:00;644;358;286;Leicht bewölkt;15;15;0
03/10/2019;16:00;653;299;354;Leicht bewölkt;14;14;0
03/10/2019;17:00;732;335;397;Leicht bewölkt;13;14;0
03/10/2019;18:00;586;251;335;Leicht bewölkt;13;13;0
03/10/2019;19:00;473;243;230;Leicht bewölkt;12;12;0
03/10/2019;20:00;322;151;171;Leicht bewölkt;12;12;0
03/10/2019;21:00;200;87;113;Leicht bewölkt;11;11;0
03/10/2019;22:00;192;75;117;Leicht bewölkt;9;9;0
03/10/2019;23:00;157;37;120;Leicht bewölkt;8;8;0
04/10/2019;00:00;81;27;54;Leicht bewölkt;7;6;0
04/10/2019;01:00;61;17;44;Leicht bewölkt;6;5;0
04/10/2019;02:00;16;3;13;Bewölkt;5;5;0
04/10/2019;03:00;20;3;17;Bewölkt;5;4;0
04/10/2019;04:00;9;5;4;Bewölkt;5;4;0
04/10/2019;05:00;49;35;14;Leicht bewölkt;5;4;0
04/10/2019;06:00;157;114;43;Leicht bewölkt;5;5;0
04/10/2019;07:00;411;287;124;Leicht bewölkt;6;6;0
04/10/2019;08:00;607;414;193;Leicht bewölkt;7;7;0
04/10/2019;09:00;609;395;214;Leicht bewölkt;8;8;0
04/10/2019;10:00;682;389;293;Leicht bewölkt;9;8;0
04/10/2019;11:00;631;336;295;Leicht bewölkt;9;8;0
04/10/2019;12:00;600;231;369;Leicht bewölkt;10;8;0
04/10/2019;13:00;583;253;330;Leicht bewölkt;9;8;0
04/10/2019;14:00;589;262;327;Leichter Regenfall;9;8;0
04/10/2019;15:00;542;251;291;Leichter Regenfall;9;8;0
04/10/2019;16:00;646;321;325;Leichter Regenfall;8;7;0
04/10/2019;17:00;654;274;380;Leichter Regenfall;8;7;0
04/10/2019;18:00;592;281;311;Leichter Regenfall;7;6;0
04/10/2019;19:00;465;227;238;Leichter Regenfall;6;6;0
04/10/2019;20:00;323;163;160;Stellenweiser Nieselregen;5;5;0
04/10/2019;21:00;234;104;130;Stellenweiser Nieselregen;4;4;0
04/10/2019;22:00;198;79;119;Stellenweiser Nieselregen;5;5;0
04/10/2019;23:00;169;44;125;Stellenweiser leichter Regenfall;6;5;0
05/10/2019;00:00;141;32;109;Stellenweiser leichter Regenfall;7;6;0
05/10/2019;01:00;66;21;45;Stellenweiser leichter Regenfall;8;6;0
05/10/2019;02:00;44;11;33;Leichter Nebel;9;7;0
05/10/2019;03:00;32;12;20;Leichter Nebel;10;7;0
05/10/2019;04:00;20;14;6;Leichter Nebel;10;7;0
05/10/2019;05:00;27;14;13;Stellenweiser Nieselregen;10;8;0
05/10/2019;06:00;41;27;14;Stellenweiser Nieselregen;10;8;0
05/10/2019;07:00;83;56;27;Stellenweiser Nieselregen;10;8;0
05/10/2019;08:00;180;124;56;Bedeckt;10;8;0
05/10/2019;09:00;345;221;124;Bedeckt;11;8;0
05/10/2019;10:00;431;272;159;Bedeckt;11;9;0
05/10/2019;11:00;540;314;226;Stellenweiser leichter Regenfall;12;10;0
05/10/2019;12:00;533;299;234;Stellenweiser leichter Regenfall;12;10;0
05/10/2019;13:00;465;219;246;Stellenweiser leichter Regenfall;12;11;0
05/10/2019;14:00;411;192;219;Leicht bewölkt;12;11;0
05/10/2019;15:00;418;179;239;Leicht bewölkt;12;12;0
05/10/2019;16:00;386;177;209;Leicht bewölkt;12;11;0
05/10/2019;17:00;432;207;225;Mäßiger bis starker Regenschauer;11;10;0
05/10/2019;18:00;343;147;196;Mäßiger bis starker Regenschauer;10;10;1
05/10/2019;19:00;308;168;140;Mäßiger bis starker Regenschauer;9;9;0
05/10/2019;20:00;200;88;112;Mäßiger bis starker Regenschauer;9;8;0
05/10/2019;21:00;179;86;93;Mäßiger bis starker Regenschauer;8;7;0
05/10/2019;22:00;138;62;76;Mäßiger bis starker Regenschauer;8;7;0
05/10/2019;23:00;155;72;83;Stellenweiser Nieselregen;8;7;0
06/10/2019;00:00;100;26;74;Stellenweiser Nieselregen;8;7;0
06/10/2019;01:00;77;18;59;Stellenweiser Nieselregen;7;7;0
06/10/2019;02:00;67;24;43;Stellenweiser Nieselregen;7;6;0
06/10/2019;03:00;27;8;19;Stellenweiser Nieselregen;7;6;0
06/10/2019;04:00;24;16;8;Stellenweiser Nieselregen;7;6;0
06/10/2019;05:00;23;10;13;Bedeckt;7;6;0
06/10/2019;06:00;32;25;7;Bedeckt;7;6;0
06/10/2019;07:00;59;36;23;Bedeckt;7;7;0
06/10/2019;08:00;80;42;38;Stellenweiser Regenfall;8;7;0
06/10/2019;09:00;157;83;74;Stellenweiser Regenfall;8;8;0
06/10/2019;10:00;178;92;86;Stellenweiser Regenfall;9;9;0
06/10/2019;11:00;292;152;140;Nieselregen;11;11;0
06/10/2019;12:00;257;112;145;Nieselregen;12;12;0
06/10/2019;13:00;327;150;177;Nieselregen;12;12;0
06/10/2019;14:00;333;165;168;Leichter Regenfall;12;12;0
06/10/2019;15:00;326;187;139;Leichter Regenfall;12;12;0
06/10/2019;16:00;320;160;160;Leichter Regenfall;12;12;0
06/10/2019;17:00;324;139;185;Leichter Regenschauer;12;11;0
06/10/2019;18:00;293;122;171;Leichter Regenschauer;12;11;0
06/10/2019;19:00;221;104;117;Leichter Regenschauer;11;10;0
06/10/2019;20:00;131;72;59;Leichter Nebel;11;10;0
06/10/2019;21:00;83;40;43;Leichter Nebel;11;10;1
06/10/2019;22:00;93;38;55;Leichter Nebel;11;9;0
06/10/2019;23:00;35;13;22;Mäßiger Regenfall;10;9;1
07/10/2019;00:00;25;15;10;Mäßiger Regenfall;10;8;2
07/10/2019;01:00;13;7;6;Mäßiger Regenfall;9;8;1
07/10/2019;02:00;1;0;1;Starker Regenfall;9;7;0
07/10/2019;03:00;4;2;2;Starker Regenfall;8;7;0
07/10/2019;04:00;12;10;2;Starker Regenfall;8;7;0
07/10/2019;05:00;62;46;16;Stellenweiser Regenfall;7;6;0
07/10/2019;06:00;211;139;72;Stellenweiser Regenfall;7;6;0
07/10/2019;07:00;1252;857;395;Stellenweiser Regenfall;8;7;0
07/10/2019;08:00;889;535;354;Bewölkt;9;8;0
07/10/2019;09:00;899;592;307;Bewölkt;10;9;0
07/10/2019;10:00;616;318;298;Bewölkt;11;11;0
07/10/2019;11:00;716;370;346;Leicht bewölkt;12;12;0
07/10/2019;12:00;819;401;418;Leicht bewölkt;14;14;0
07/10/2019;13:00;1208;529;679;Leicht bewölkt;14;14;0
07/10/2019;14:00;871;453;418;Stellenweiser Regenfall;14;15;0
07/10/2019;15:00;1346;577;769;Stellenweiser Regenfall;15;15;0
07/10/2019;16:00;1195;573;622;Stellenweiser Regenfall;14;14;0
07/10/2019;17:00;1307;559;748;Stellenweiser Regenfall;14;14;0
07/10/2019;18:00;1092;490;602;Stellenweiser Regenfall;13;13;0
07/10/2019;19:00;724;307;417;Stellenweiser Regenfall;12;12;0
07/10/2019;20:00;515;237;278;Stellenweiser Regenfall;11;10;0
07/10/2019;21:00;341;137;204;Stellenweiser Regenfall;9;9;0
07/10/2019;22:00;263;99;164;Stellenweiser Regenfall;9;8;0
07/10/2019;23:00;131;40;91;Leicht bewölkt;8;7;0
08/10/2019;00:00;74;25;49;Leicht bewölkt;7;6;0
08/10/2019;01:00;31;11;20;Leicht bewölkt;7;6;0
08/10/2019;02:00;17;9;8;Leicht bewölkt;6;5;0
08/10/2019;03:00;8;4;4;Leicht bewölkt;6;5;0
08/10/2019;04:00;13;9;4;Leicht bewölkt;6;5;0
08/10/2019;05:00;71;62;9;Leicht bewölkt;7;6;0
08/10/2019;06:00;229;148;81;Leicht bewölkt;7;6;0
08/10/2019;07:00;1414;967;447;Leicht bewölkt;8;7;0
08/10/2019;08:00;959;595;364;Bedeckt;9;9;0
08/10/2019;09:00;985;672;313;Bedeckt;11;10;0
08/10/2019;10:00;583;318;265;Bedeckt;11;11;0
08/10/2019;11:00;949;491;458;Bedeckt;12;12;0
08/10/2019;12:00;892;320;572;Bedeckt;13;13;0
08/10/2019;13:00;1154;543;611;Bedeckt;14;13;0
08/10/2019;14:00;806;382;424;Bewölkt;14;14;0
08/10/2019;15:00;1230;546;684;Bewölkt;15;15;0
08/10/2019;16:00;1154;578;576;Bewölkt;15;14;0
08/10/2019;17:00;1342;569;773;Leicht bewölkt;14;14;0
08/10/2019;18:00;1177;541;636;Leicht bewölkt;14;13;0
08/10/2019;19:00;826;359;467;Leicht bewölkt;13;12;0
08/10/2019;20:00;487;188;299;Leicht bewölkt;12;11;0
08/10/2019;21:00;412;134;278;Leicht bewölkt;11;10;0
08/10/2019;22:00;286;103;183;Leicht bewölkt;11;11;0
08/10/2019;23:00;147;56;91;Leicht bewölkt;12;11;0
09/10/2019;00:00;71;27;44;Leicht bewölkt;12;12;0
09/10/2019;01:00;35;6;29;Leicht bewölkt;12;12;0
09/10/2019;02:00;11;4;7;Bedeckt;13;12;0
09/10/2019;03:00;6;2;4;Bedeckt;13;13;0
09/10/2019;04:00;14;11;3;Bedeckt;13;13;0
09/10/2019;05:00;52;32;20;Mäßiger Regenfall;13;13;1
09/10/2019;06:00;155;110;45;Mäßiger Regenfall;13;12;1
09/10/2019;07:00;776;529;247;Mäßiger Regenfall;12;12;1
09/10/2019;08:00;592;365;227;Starker Regenfall;12;12;1
09/10/2019;09:00;477;304;173;Starker Regenfall;12;11;1
09/10/2019;10:00;263;146;117;Starker Regenfall;11;10;1
09/10/2019;11:00;320;132;188;Starker Regenfall;10;9;1
09/10/2019;12:00;407;177;230;Starker Regenfall;10;8;2
09/10/2019;13:00;637;308;329;Starker Regenfall;10;7;1
09/10/2019;14:00;367;137;230;Starker Regenfall;9;7;1
09/10/2019;15:00;611;255;356;Starker Regenfall;9;6;1
09/10/2019;16:00;577;274;303;Starker Regenfall;9;6;1
09/10/2019;17:00;782;376;406;Mäßiger Regenfall;9;6;0
09/10/2019;18:00;665;306;359;Mäßiger Regenfall;8;6;0
09/10/2019;19:00;502;221;281;Mäßiger Regenfall;8;6;0
09/10/2019;20:00;379;170;209;Stellenweiser leichter Regenfall;8;6;0
09/10/2019;21:00;244;101;143;Stellenweiser leichter Regenfall;8;6;0
09/10/2019;22:00;181;73;108;Stellenweiser leichter Regenfall;8;6;0
09/10/2019;23:00;106;49;57;Leichter Regenschauer;8;6;0
10/10/2019;00:00;65;29;36;Leichter Regenschauer;8;6;0
10/10/2019;01:00;44;10;34;Leichter Regenschauer;8;6;0
10/10/2019;02:00;17;8;9;Stellenweiser Regenfall;8;6;0
10/10/2019;03:00;3;2;1;Stellenweiser Regenfall;8;6;0
10/10/2019;04:00;10;7;3;Stellenweiser Regenfall;8;6;0
10/10/2019;05:00;58;42;16;Leichter Regenschauer;8;6;0
10/10/2019;06:00;211;140;71;Leichter Regenschauer;8;6;0
10/10/2019;07:00;1260;833;427;Leichter Regenschauer;9;6;0
10/10/2019;08:00;920;571;349;Stellenweiser Regenfall;9;7;0
10/10/2019;09:00;833;568;265;Stellenweiser Regenfall;10;8;0
10/10/2019;10:00;585;334;251;Stellenweiser Regenfall;10;8;0
10/10/2019;11:00;773;385;388;Leichter Regenfall;11;9;0
10/10/2019;12:00;795;357;438;Leichter Regenfall;12;10;0
10/10/2019;13:00;1140;494;646;Leichter Regenfall;12;10;0
10/10/2019;14:00;769;384;385;Stellenweiser leichter Regenfall;13;11;0
10/10/2019;15:00;1231;598;633;Stellenweiser leichter Regenfall;13;12;0
10/10/2019;16:00;1096;527;569;Stellenweiser leichter Regenfall;12;11;0
10/10/2019;17:00;1305;517;788;Stellenweiser Regenfall;12;11;0
10/10/2019;18:00;1106;509;597;Stellenweiser Regenfall;11;11;0
10/10/2019;19:00;778;336;442;Stellenweiser Regenfall;10;10;0
10/10/2019;20:00;487;205;282;Leicht bewölkt;9;9;0
10/10/2019;21:00;331;131;200;Leicht bewölkt;8;8;0
10/10/2019;22:00;336;118;218;Leicht bewölkt;7;7;0
10/10/2019;23:00;160;57;103;Leicht bewölkt;7;6;0
11/10/2019;00:00;92;43;49;Leicht bewölkt;6;6;0
11/10/2019;01:00;57;19;38;Leicht bewölkt;6;5;0
11/10/2019;02:00;9;3;6;Leicht bewölkt;6;5;0
11/10/2019;03:00;14;7;7;Leicht bewölkt;6;5;0
11/10/2019;04:00;16;12;4;Leicht bewölkt;5;4;0
11/10/2019;05:00;52;39;13;Leicht bewölkt;5;4;0
11/10/2019;06:00;212;136;76;Leicht bewölkt;5;4;0
11/10/2019;07:00;1219;827;392;Leicht bewölkt;7;6;0
11/10/2019;08:00;939;601;338;Leicht bewölkt;9;8;0
11/10/2019;09:00;835;530;305;Leicht bewölkt;11;10;0
11/10/2019;10:00;713;415;298;Leicht bewölkt;13;12;0
11/10/2019;11:00;942;429;513;Leicht bewölkt;15;15;0
11/10/2019;12:00;1094;496;598;Leicht bewölkt;17;17;0
11/10/2019;13:00;1305;542;763;Leicht bewölkt;18;18;0
11/10/2019;14:00;1016;495;521;Sonnig;18;18;0
11/10/2019;15:00;1077;540;537;Sonnig;19;19;0
11/10/2019;16:00;1096;547;549;Sonnig;18;18;0
11/10/2019;17:00;1045;439;606;Sonnig;17;17;0
11/10/2019;18:00;901;439;462;Sonnig;16;16;0
11/10/2019;19:00;774;359;415;Sonnig;15;15;0
11/10/2019;20:00;418;201;217;Sonnig;14;14;0
11/10/2019;21:00;312;161;151;Sonnig;12;12;0
11/10/2019;22:00;277;117;160;Sonnig;12;11;0
11/10/2019;23:00;208;74;134;Sonnig;11;10;0
12/10/2019;00:00;152;35;117;Sonnig;10;10;0
12/10/2019;01:00;89;16;73;Sonnig;10;9;0
12/10/2019;02:00;63;17;46;Sonnig;9;9;0
12/10/2019;03:00;45;15;30;Sonnig;9;9;0
12/10/2019;04:00;16;6;10;Sonnig;9;8;0
12/10/2019;05:00;27;17;10;Sonnig;9;8;0
12/10/2019;06:00;68;48;20;Sonnig;8;8;0
12/10/2019;07:00;106;69;37;Sonnig;10;10;0
12/10/2019;08:00;263;177;86;Leicht bewölkt;12;12;0
12/10/2019;09:00;503;317;186;Leicht bewölkt;14;13;0
12/10/2019;10:00;695;429;266;Leicht bewölkt;16;15;0
12/10/2019;11:00;819;473;346;Leicht bewölkt;18;18;0
12/10/2019;12:00;847;487;360;Leicht bewölkt;20;20;0
12/10/2019;13:00;844;400;444;Leicht bewölkt;20;20;0
12/10/2019;14:00;913;476;437;Leicht bewölkt;20;20;0
12/10/2019;15:00;801;390;411;Leicht bewölkt;20;20;0
12/10/2019;16:00;829;387;442;Leicht bewölkt;19;19;0
12/10/2019;17:00;803;355;448;Leicht bewölkt;18;18;0
12/10/2019;18:00;752;328;424;Leicht bewölkt;17;17;0
12/10/2019;19:00;540;262;278;Leicht bewölkt;16;16;0
12/10/2019;20:00;363;170;193;Leicht bewölkt;14;14;0
12/10/2019;21:00;262;104;158;Leicht bewölkt;13;13;0
12/10/2019;22:00;258;119;139;Leicht bewölkt;12;12;0
12/10/2019;23:00;233;73;160;Leicht bewölkt;12;11;0
13/10/2019;00:00;135;57;78;Leicht bewölkt;11;10;0
13/10/2019;01:00;121;49;72;Leicht bewölkt;11;10;0
13/10/2019;02:00;95;35;60;Leicht bewölkt;10;10;0
13/10/2019;03:00;71;23;48;Leicht bewölkt;10;10;0
13/10/2019;04:00;24;16;8;Leicht bewölkt;10;10;0
13/10/2019;05:00;19;5;14;Leicht bewölkt;10;10;0
13/10/2019;06:00;39;28;11;Leicht bewölkt;9;10;0
13/10/2019;07:00;48;31;17;Leicht bewölkt;11;11;0
13/10/2019;08:00;104;58;46;Leicht bewölkt;13;13;0
13/10/2019;09:00;263;139;124;Leicht bewölkt;15;15;0
13/10/2019;10:00;375;200;175;Leicht bewölkt;17;17;0
13/10/2019;11:00;558;291;267;Leicht bewölkt;19;19;0
13/10/2019;12:00;781;431;350;Leicht bewölkt;21;21;0
13/10/2019;13:00;849;497;352;Leicht bewölkt;21;21;0
13/10/2019;14:00;928;498;430;Leicht bewölkt;21;21;0
13/10/2019;15:00;984;499;485;Leicht bewölkt;21;21;0
13/10/2019;16:00;929;417;512;Leicht bewölkt;21;21;0
13/10/2019;17:00;870;376;494;Leicht bewölkt;20;20;0
13/10/2019;18:00;801;363;438;Leicht bewölkt;20;20;0
13/10/2019;19:00;381;160;221;Leicht bewölkt;19;19;0
13/10/2019;20:00;289;133;156;Leicht bewölkt;18;18;0
13/10/2019;21:00;157;59;98;Leicht bewölkt;18;18;0
13/10/2019;22:00;155;56;99;Leicht bewölkt;16;16;0
13/10/2019;23:00;78;24;54;Leicht bewölkt;15;15;0
14/10/2019;00:00;43;19;24;Leicht bewölkt;13;14;0
14/10/2019;01:00;23;10;13;Leicht bewölkt;13;13;0
14/10/2019;02:00;7;3;4;Leicht bewölkt;12;12;0
14/10/2019;03:00;7;3;4;Leicht bewölkt;11;12;0
14/10/2019;04:00;11;10;1;Leicht bewölkt;11;11;0
14/10/2019;05:00;54;39;15;Leicht bewölkt;11;11;0
14/10/2019;06:00;239;153;86;Leicht bewölkt;11;11;0
14/10/2019;07:00;1318;906;412;Leicht bewölkt;13;13;0
14/10/2019;08:00;976;566;410;Leicht bewölkt;15;15;0
14/10/2019;09:00;870;551;319;Leicht bewölkt;16;16;0
14/10/2019;10:00;622;346;276;Leicht bewölkt;18;18;0
14/10/2019;11:00;815;417;398;Leicht bewölkt;20;20;0
14/10/2019;12:00;885;419;466;Leicht bewölkt;21;21;0
14/10/2019;13:00;1333;601;732;Leicht bewölkt;22;22;0
14/10/2019;14:00;924;475;449;Leicht bewölkt;22;22;0
14/10/2019;15:00;1422;680;742;Leicht bewölkt;22;25;0
14/10/2019;16:00;1371;650;721;Leicht bewölkt;22;22;0
14/10/2019;17:00;1539;697;842;Leicht bewölkt;21;21;0
14/10/2019;18:00;1204;566;638;Leicht bewölkt;21;21;0
14/10/2019;19:00;797;375;422;Leicht bewölkt;20;20;0
14/10/2019;20:00;599;267;332;Leicht bewölkt;20;20;0
14/10/2019;21:00;394;176;218;Leicht bewölkt;19;19;0
14/10/2019;22:00;302;118;184;Leicht bewölkt;17;17;0
14/10/2019;23:00;128;45;83;Leicht bewölkt;15;15;0
15/10/2019;00:00;90;21;69;Leicht bewölkt;13;13;0
15/10/2019;01:00;49;15;34;Leicht bewölkt;12;12;0
15/10/2019;02:00;28;15;13;Leicht bewölkt;11;11;0
15/10/2019;03:00;13;7;6;Leicht bewölkt;10;10;0
15/10/2019;04:00;19;15;4;Leicht bewölkt;10;10;0
15/10/2019;05:00;68;49;19;Leicht bewölkt;10;10;0
15/10/2019;06:00;198;121;77;Leicht bewölkt;10;10;0
15/10/2019;07:00;1292;860;432;Leicht bewölkt;12;12;0
15/10/2019;08:00;957;608;349;Leicht bewölkt;14;14;0
15/10/2019;09:00;998;668;330;Leicht bewölkt;15;15;0
15/10/2019;10:00;667;384;283;Leicht bewölkt;17;17;0
15/10/2019;11:00;919;504;415;Leicht bewölkt;18;18;0
15/10/2019;12:00;911;366;545;Leicht bewölkt;19;19;0
15/10/2019;13:00;1181;552;629;Leicht bewölkt;18;17;0
15/10/2019;14:00;842;412;430;Leicht bewölkt;17;16;0
15/10/2019;15:00;1219;532;687;Leicht bewölkt;16;14;0
15/10/2019;16:00;1185;571;614;Leicht bewölkt;15;13;0
15/10/2019;17:00;1225;538;687;Stellenweiser Regenfall;13;12;0
15/10/2019;18:00;845;343;502;Stellenweiser Regenfall;12;12;0
15/10/2019;19:00;612;263;349;Stellenweiser Regenfall;12;10;0
15/10/2019;20:00;344;120;224;Mäßiger Regenfall;11;9;1
15/10/2019;21:00;251;88;163;Mäßiger Regenfall;10;8;1
15/10/2019;22:00;201;68;133;Mäßiger Regenfall;10;8;0
15/10/2019;23:00;104;43;61;Mäßiger Regenfall;9;7;1
16/10/2019;00:00;57;19;38;Mäßiger Regenfall;9;7;1
16/10/2019;01:00;29;15;14;Mäßiger Regenfall;9;7;1
16/10/2019;02:00;11;2;9;Mäßiger Regenfall;9;7;0
16/10/2019;03:00;7;3;4;Mäßiger Regenfall;9;7;0
16/10/2019;04:00;12;7;5;Mäßiger Regenfall;8;7;0
16/10/2019;05:00;62;41;21;Leicht bewölkt;8;7;0
16/10/2019;06:00;222;144;78;Leicht bewölkt;8;6;0
16/10/2019;07:00;1335;919;416;Leicht bewölkt;8;8;0
16/10/2019;08:00;973;618;355;Leicht bewölkt;9;9;0
16/10/2019;09:00;983;632;351;Leicht bewölkt;10;10;0
16/10/2019;10:00;636;340;296;Leicht bewölkt;12;11;0
16/10/2019;11:00;870;406;464;Leicht bewölkt;13;13;0
16/10/2019;12:00;975;450;525;Leicht bewölkt;15;15;0
16/10/2019;13:00;1248;634;614;Leicht bewölkt;16;16;0
16/10/2019;14:00;987;508;479;Leicht bewölkt;16;16;0
16/10/2019;15:00;1381;614;767;Leicht bewölkt;17;17;0
16/10/2019;16:00;1262;605;657;Leicht bewölkt;16;16;0
16/10/2019;17:00;1409;628;781;Leicht bewölkt;15;15;0
16/10/2019;18:00;1230;584;646;Leicht bewölkt;15;15;0
16/10/2019;19:00;916;438;478;Leicht bewölkt;13;13;0
16/10/2019;20:00;572;257;315;Leicht bewölkt;12;12;0
16/10/2019;21:00;418;164;254;Leicht bewölkt;11;11;0
16/10/2019;22:00;322;77;245;Leicht bewölkt;10;10;0
16/10/2019;23:00;161;52;109;Leicht bewölkt;9;9;0
17/10/2019;00:00;107;26;81;Leicht bewölkt;8;8;0
17/10/2019;01:00;48;8;40;Leicht bewölkt;8;8;0
17/10/2019;02:00;18;8;10;Leicht bewölkt;7;7;0
17/10/2019;03:00;12;7;5;Leicht bewölkt;7;7;0
17/10/2019;04:00;19;10;9;Leicht bewölkt;7;7;0
17/10/2019;05:00;60;43;17;Leicht bewölkt;7;7;0
17/10/2019;06:00;191;130;61;Leicht bewölkt;7;7;0
17/10/2019;07:00;1368;912;456;Leicht bewölkt;9;9;0
17/10/2019;08:00;947;581;366;Bewölkt;11;11;0
17/10/2019;09:00;896;594;302;Bewölkt;13;13;0
17/10/2019;10:00;605;345;260;Bewölkt;14;14;0
17/10/2019;11:00;862;407;455;Leicht bewölkt;16;16;0
17/10/2019;12:00;885;418;467;Leicht bewölkt;18;18;0
17/10/2019;13:00;1248;524;724;Leicht bewölkt;18;18;0
17/10/2019;14:00;966;486;480;Leicht bewölkt;18;18;0
17/10/2019;15:00;1304;614;690;Leicht bewölkt;18;18;0
17/10/2019;16:00;1233;634;599;Leicht bewölkt;16;16;0
17/10/2019;17:00;1429;614;815;Leicht bewölkt;15;15;0
17/10/2019;18:00;1216;585;631;Leicht bewölkt;14;14;0
17/10/2019;19:00;878;465;413;Leicht bewölkt;13;13;0
17/10/2019;20:00;556;252;304;Bewölkt;12;12;0
17/10/2019;21:00;435;173;262;Bewölkt;11;11;0
17/10/2019;22:00;333;128;205;Bewölkt;11;11;0
17/10/2019;23:00;231;87;144;Bewölkt;11;11;0
18/10/2019;00:00;109;26;83;Bewölkt;11;11;0
18/10/2019;01:00;96;12;84;Bewölkt;11;11;0
18/10/2019;02:00;82;9;73;Leicht bewölkt;10;10;0
18/10/2019;03:00;55;10;45;Leicht bewölkt;10;10;0
18/10/2019;04:00;18;6;12;Leicht bewölkt;10;10;0
18/10/2019;05:00;57;43;14;Bewölkt;10;10;0
18/10/2019;06:00;195;122;73;Bewölkt;10;10;0
18/10/2019;07:00;1161;793;368;Bewölkt;11;11;0
18/10/2019;08:00;837;532;305;Bewölkt;12;12;0
18/10/2019;09:00;936;608;328;Bewölkt;13;13;0
18/10/2019;10:00;640;371;269;Bewölkt;14;15;0
18/10/2019;11:00;828;408;420;Leicht bewölkt;16;16;0
18/10/2019;12:00;894;404;490;Leicht bewölkt;17;17;0
18/10/2019;13:00;1213;459;754;Leicht bewölkt;17;17;0
18/10/2019;14:00;857;454;403;Leicht bewölkt;17;17;0
18/10/2019;15:00;958;447;511;Leicht bewölkt;17;17;0
18/10/2019;16:00;936;417;519;Leicht bewölkt;16;16;0
18/10/2019;17:00;910;410;500;Leicht bewölkt;15;15;0
18/10/2019;18:00;848;380;468;Leicht bewölkt;14;13;0
18/10/2019;19:00;731;372;359;Leicht bewölkt;13;13;0
18/10/2019;20:00;448;223;225;Leicht bewölkt;12;12;0
18/10/2019;21:00;300;157;143;Leicht bewölkt;11;11;0
18/10/2019;22:00;302;118;184;Leicht bewölkt;11;11;0
18/10/2019;23:00;261;107;154;Bedeckt;11;10;0
19/10/2019;00:00;188;49;139;Bedeckt;10;10;0
19/10/2019;01:00;165;45;120;Bedeckt;10;10;0
19/10/2019;02:00;61;16;45;Bedeckt;10;10;0
19/10/2019;03:00;72;17;55;Bedeckt;10;10;0
19/10/2019;04:00;20;6;14;Bedeckt;10;10;0
19/10/2019;05:00;30;20;10;Leicht bewölkt;9;9;0
19/10/2019;06:00;53;39;14;Leicht bewölkt;9;9;0
19/10/2019;07:00;105;66;39;Leicht bewölkt;10;10;0
19/10/2019;08:00;201;132;69;Bedeckt;10;11;0
19/10/2019;09:00;342;226;116;Bedeckt;11;11;0
19/10/2019;10:00;303;189;114;Bedeckt;13;13;0
19/10/2019;11:00;331;166;165;Bedeckt;14;14;0
19/10/2019;12:00;323;175;148;Bedeckt;16;16;0
19/10/2019;13:00;398;222;176;Bedeckt;16;16;0
19/10/2019;14:00;595;329;266;Leicht bewölkt;16;16;0
19/10/2019;15:00;660;390;270;Leicht bewölkt;17;17;0
19/10/2019;16:00;665;367;298;Leicht bewölkt;15;15;0
19/10/2019;17:00;691;296;395;Leicht bewölkt;14;14;0
19/10/2019;18:00;604;279;325;Leicht bewölkt;13;12;0
19/10/2019;19:00;500;307;193;Leicht bewölkt;12;11;0
19/10/2019;20:00;339;173;166;Leicht bewölkt;11;10;0
19/10/2019;21:00;314;111;203;Leicht bewölkt;10;9;0
19/10/2019;22:00;266;95;171;Leicht bewölkt;10;9;0
19/10/2019;23:00;182;55;127;Leicht bewölkt;9;9;0
20/10/2019;00:00;205;70;135;Leicht bewölkt;9;9;0
20/10/2019;01:00;145;50;95;Leicht bewölkt;9;9;0
20/10/2019;02:00;110;40;70;Leicht bewölkt;9;9;0
20/10/2019;03:00;77;21;56;Leicht bewölkt;9;9;0
20/10/2019;04:00;32;19;13;Leicht bewölkt;9;9;0
20/10/2019;05:00;25;11;14;Leicht bewölkt;9;9;0
20/10/2019;06:00;52;38;14;Leicht bewölkt;9;9;0
20/10/2019;07:00;37;22;15;Leicht bewölkt;10;10;0
20/10/2019;08:00;99;51;48;Leicht bewölkt;12;12;0
20/10/2019;09:00;230;151;79;Leicht bewölkt;14;14;0
20/10/2019;10:00;568;454;114;Leicht bewölkt;16;16;0
20/10/2019;11:00;630;489;141;Leicht bewölkt;18;18;0
20/10/2019;12:00;753;412;341;Leicht bewölkt;20;20;0
20/10/2019;13:00;800;349;451;Leicht bewölkt;20;20;0
20/10/2019;14:00;851;387;464;Leicht bewölkt;21;21;0
20/10/2019;15:00;985;548;437;Leicht bewölkt;21;21;0
20/10/2019;16:00;862;405;457;Leicht bewölkt;20;20;0
20/10/2019;17:00;966;334;632;Leicht bewölkt;20;20;0
20/10/2019;18:00;544;249;295;Leicht bewölkt;19;19;0
20/10/2019;19:00;374;159;215;Leicht bewölkt;18;18;0
20/10/2019;20:00;305;105;200;Leicht bewölkt;18;18;0
20/10/2019;21:00;163;59;104;Leicht bewölkt;17;17;0
20/10/2019;22:00;143;40;103;Leicht bewölkt;15;15;0
20/10/2019;23:00;77;29;48;Leicht bewölkt;14;14;0
21/10/2019;00:00;47;22;25;Leicht bewölkt;13;13;0
21/10/2019;01:00;15;7;8;Leicht bewölkt;12;12;0
21/10/2019;02:00;7;7;0;Leicht bewölkt;11;11;0
21/10/2019;03:00;5;3;2;Leicht bewölkt;11;11;0
21/10/2019;04:00;14;9;5;Leicht bewölkt;10;10;0
21/10/2019;05:00;49;40;9;Leicht bewölkt;10;10;0
21/10/2019;06:00;222;156;66;Leicht bewölkt;10;10;0
21/10/2019;07:00;1017;674;343;Leicht bewölkt;11;11;0
21/10/2019;08:00;751;434;317;Leicht bewölkt;12;12;0
21/10/2019;09:00;746;456;290;Leicht bewölkt;13;13;0
21/10/2019;10:00;483;283;200;Leicht bewölkt;15;15;0
21/10/2019;11:00;671;355;316;Leicht bewölkt;16;16;0
21/10/2019;12:00;749;347;402;Leicht bewölkt;17;17;0
21/10/2019;13:00;1018;488;530;Leicht bewölkt;17;17;0
21/10/2019;14:00;703;358;345;Stellenweiser Regenfall;17;17;0
21/10/2019;15:00;1046;512;534;Stellenweiser Regenfall;17;17;0
21/10/2019;16:00;997;484;513;Stellenweiser Regenfall;16;16;0
21/10/2019;17:00;1181;530;651;Bedeckt;15;14;0
21/10/2019;18:00;961;448;513;Bedeckt;14;13;0
21/10/2019;19:00;768;333;435;Bedeckt;13;13;0
21/10/2019;20:00;513;229;284;Bewölkt;13;12;0
21/10/2019;21:00;339;136;203;Bewölkt;12;11;0
21/10/2019;22:00;292;117;175;Bewölkt;12;11;0
21/10/2019;23:00;118;38;80;Bedeckt;12;11;0
22/10/2019;00:00;80;29;51;Bedeckt;11;11;0
22/10/2019;01:00;27;6;21;Bedeckt;11;11;0
22/10/2019;02:00;6;6;0;Bedeckt;11;10;0
22/10/2019;03:00;13;8;5;Bedeckt;11;10;0
22/10/2019;04:00;8;4;4;Bedeckt;11;10;0
22/10/2019;05:00;63;49;14;Bedeckt;11;9;0
22/10/2019;06:00;248;179;69;Bedeckt;10;9;0
22/10/2019;07:00;1394;921;473;Bedeckt;11;10;0
22/10/2019;08:00;994;611;383;Bewölkt;12;11;0
22/10/2019;09:00;1050;673;377;Bewölkt;13;12;0
22/10/2019;10:00;635;363;272;Bewölkt;14;13;0
22/10/2019;11:00;881;471;410;Leicht bewölkt;15;14;0
22/10/2019;12:00;890;377;513;Leicht bewölkt;16;15;0
22/10/2019;13:00;1227;552;675;Leicht bewölkt;16;16;0
22/10/2019;14:00;790;366;424;Leicht bewölkt;16;16;0
22/10/2019;15:00;1326;577;749;Leicht bewölkt;16;16;0
22/10/2019;16:00;1128;540;588;Leicht bewölkt;16;16;0
22/10/2019;17:00;1427;692;735;Leicht bewölkt;15;15;0
22/10/2019;18:00;1206;560;646;Leicht bewölkt;15;15;0
22/10/2019;19:00;950;407;543;Leicht bewölkt;14;13;0
22/10/2019;20:00;518;235;283;Leicht bewölkt;12;12;0
22/10/2019;21:00;417;178;239;Leicht bewölkt;11;10;0
22/10/2019;22:00;344;107;237;Leicht bewölkt;10;10;0
22/10/2019;23:00;184;68;116;Leichter Nebel;9;9;0
23/10/2019;00:00;84;27;57;Leichter Nebel;9;8;0
23/10/2019;01:00;65;31;34;Leichter Nebel;8;8;0
23/10/2019;02:00;22;8;14;Leichter Nebel;8;8;0
23/10/2019;03:00;14;8;6;Leichter Nebel;8;8;0
23/10/2019;04:00;9;6;3;Leichter Nebel;8;8;0
23/10/2019;05:00;60;37;23;Leichter Nebel;8;7;0
23/10/2019;06:00;245;173;72;Leichter Nebel;7;7;0
23/10/2019;07:00;1442;961;481;Leichter Nebel;9;9;0
23/10/2019;08:00;1025;656;369;Leichter Nebel;11;11;0
23/10/2019;09:00;947;608;339;Leichter Nebel;13;13;0
23/10/2019;10:00;626;355;271;Leichter Nebel;15;15;0
23/10/2019;11:00;776;378;398;Sonnig;17;17;0
23/10/2019;12:00;934;422;512;Sonnig;19;19;0
23/10/2019;13:00;1282;604;678;Sonnig;19;19;0
23/10/2019;14:00;936;481;455;Sonnig;20;20;0
23/10/2019;15:00;1227;535;692;Sonnig;20;20;0
23/10/2019;16:00;1231;573;658;Sonnig;19;19;0
23/10/2019;17:00;1411;656;755;Leicht bewölkt;19;19;0
23/10/2019;18:00;1198;593;605;Leicht bewölkt;18;18;0
23/10/2019;19:00;912;443;469;Leicht bewölkt;17;17;0
23/10/2019;20:00;678;297;381;Leicht bewölkt;16;16;0
23/10/2019;21:00;402;155;247;Leicht bewölkt;14;14;0
23/10/2019;22:00;381;114;267;Leicht bewölkt;13;13;0
23/10/2019;23:00;228;85;143;Leicht bewölkt;12;12;0
24/10/2019;00:00;81;26;55;Leicht bewölkt;12;12;0
24/10/2019;01:00;48;15;33;Leicht bewölkt;11;11;0
24/10/2019;02:00;21;14;7;Leicht bewölkt;11;11;0
24/10/2019;03:00;24;19;5;Leicht bewölkt;11;11;0
24/10/2019;04:00;16;12;4;Leicht bewölkt;10;10;0
24/10/2019;05:00;72;58;14;Leicht bewölkt;10;10;0
24/10/2019;06:00;251;173;78;Leicht bewölkt;10;10;0
24/10/2019;07:00;1437;970;467;Leicht bewölkt;11;11;0
24/10/2019;08:00;1026;624;402;Leicht bewölkt;12;12;0
24/10/2019;09:00;914;587;327;Leicht bewölkt;13;14;0
24/10/2019;10:00;589;344;245;Leicht bewölkt;14;15;0
24/10/2019;11:00;760;383;377;Leicht bewölkt;16;16;0
24/10/2019;12:00;866;367;499;Leicht bewölkt;17;17;0
24/10/2019;13:00;1215;490;725;Leicht bewölkt;17;17;0
24/10/2019;14:00;863;450;413;Leicht bewölkt;17;17;0
24/10/2019;15:00;1243;621;622;Leicht bewölkt;17;17;0
24/10/2019;16:00;1202;559;643;Leicht bewölkt;17;17;0
24/10/2019;17:00;1373;601;772;Leicht bewölkt;16;16;0
24/10/2019;18:00;1256;568;688;Leicht bewölkt;15;15;0
24/10/2019;19:00;806;371;435;Leicht bewölkt;14;14;0
24/10/2019;20:00;535;223;312;Leicht bewölkt;13;13;0
24/10/2019;21:00;393;149;244;Leicht bewölkt;13;13;0
24/10/2019;22:00;355;116;239;Leicht bewölkt;12;12;0
24/10/2019;23:00;183;70;113;Bedeckt;12;12;0
25/10/2019;00:00;98;41;57;Bedeckt;12;12;0
25/10/2019;01:00;93;53;40;Bedeckt;12;12;0
25/10/2019;02:00;26;13;13;Nieselregen;12;12;0
25/10/2019;03:00;20;14;6;Nieselregen;12;12;0
25/10/2019;04:00;12;10;2;Nieselregen;12;11;0
25/10/2019;05:00;51;35;16;Stellenweiser Nieselregen;11;11;0
25/10/2019;06:00;205;129;76;Stellenweiser Nieselregen;11;10;0
25/10/2019;07:00;1255;826;429;Stellenweiser Nieselregen;11;11;0
25/10/2019;08:00;941;600;341;Leicht bewölkt;12;12;0
25/10/2019;09:00;912;552;360;Leicht bewölkt;13;13;0
25/10/2019;10:00;678;415;263;Leicht bewölkt;14;14;0
25/10/2019;11:00;831;448;383;Leicht bewölkt;15;15;0
25/10/2019;12:00;1103;484;619;Leicht bewölkt;16;17;0
25/10/2019;13:00;1333;543;790;Leicht bewölkt;17;17;0
25/10/2019;14:00;1017;502;515;Leicht bewölkt;17;17;0
25/10/2019;15:00;999;487;512;Leicht bewölkt;17;17;0
25/10/2019;16:00;973;490;483;Leicht bewölkt;16;16;0
25/10/2019;17:00;1005;471;534;Leicht bewölkt;16;16;0
25/10/2019;18:00;1011;464;547;Leicht bewölkt;15;15;0
25/10/2019;19:00;662;316;346;Leicht bewölkt;14;14;0
25/10/2019;20:00;405;213;192;Leicht bewölkt;12;12;0
25/10/2019;21:00;302;109;193;Leicht bewölkt;11;11;0
25/10/2019;22:00;291;104;187;Leicht bewölkt;10;10;0
25/10/2019;23:00;233;68;165;Leicht bewölkt;10;10;0
26/10/2019;00:00;163;52;111;Leicht bewölkt;9;9;0
26/10/2019;01:00;114;31;83;Leicht bewölkt;9;9;0
26/10/2019;02:00;71;33;38;Leicht bewölkt;8;8;0
26/10/2019;03:00;45;17;28;Leicht bewölkt;8;8;0
26/10/2019;04:00;22;14;8;Leicht bewölkt;8;8;0
26/10/2019;05:00;29;18;11;Leichter Nebel;8;8;0
26/10/2019;06:00;61;43;18;Leichter Nebel;8;8;0
26/10/2019;07:00;96;71;25;Leichter Nebel;9;9;0
26/10/2019;08:00;220;130;90;Leichter Nebel;11;11;0
26/10/2019;09:00;403;259;144;Leichter Nebel;12;12;0
26/10/2019;10:00;508;309;199;Leichter Nebel;14;14;0
26/10/2019;11:00;675;388;287;Leicht bewölkt;16;16;0
26/10/2019;12:00;673;390;283;Leicht bewölkt;18;18;0
26/10/2019;13:00;667;372;295;Leicht bewölkt;19;19;0
26/10/2019;14:00;721;379;342;Sonnig;19;19;0
26/10/2019;15:00;706;363;343;Sonnig;20;20;0
26/10/2019;16:00;731;324;407;Sonnig;19;19;0
26/10/2019;17:00;674;306;368;Sonnig;18;18;0
26/10/2019;18:00;604;248;356;Sonnig;17;17;0
26/10/2019;19:00;428;220;208;Sonnig;16;16;0
26/10/2019;20:00;328;147;181;Leicht bewölkt;15;15;0
26/10/2019;21:00;225;111;114;Leicht bewölkt;14;14;0
26/10/2019;22:00;204;77;127;Leicht bewölkt;14;14;0
26/10/2019;23:00;183;66;117;Sonnig;13;14;0
27/10/2019;00:00;175;65;110;Sonnig;13;13;0
27/10/2019;01:00;135;34;101;Sonnig;12;13;0
27/10/2019;02:00;106;28;78;Leicht bewölkt;11;12;0
27/10/2019;03:00;38;12;26;Leicht bewölkt;11;11;0
27/10/2019;04:00;21;8;13;Leicht bewölkt;10;10;0
27/10/2019;05:00;25;12;13;Leicht bewölkt;10;10;0
27/10/2019;06:00;40;31;9;Leicht bewölkt;9;9;0
27/10/2019;07:00;57;36;21;Leicht bewölkt;11;11;0
27/10/2019;08:00;91;50;41;Leicht bewölkt;12;12;0
27/10/2019;09:00;253;137;116;Leicht bewölkt;14;14;0
27/10/2019;10:00;302;165;137;Leicht bewölkt;15;15;0
27/10/2019;11:00;343;181;162;Leicht bewölkt;16;16;0
27/10/2019;12:00;453;210;243;Leicht bewölkt;18;18;0
27/10/2019;13:00;476;235;241;Leicht bewölkt;18;18;0
27/10/2019;14:00;573;289;284;Leicht bewölkt;18;18;0
27/10/2019;15:00;548;282;266;Leicht bewölkt;18;18;0
27/10/2019;16:00;629;276;353;Leicht bewölkt;17;17;0
27/10/2019;17:00;497;259;238;Leicht bewölkt;16;16;0
27/10/2019;18:00;354;183;171;Leicht bewölkt;15;15;0
27/10/2019;19:00;266;142;124;Leicht bewölkt;14;14;0
27/10/2019;20:00;199;80;119;Leicht bewölkt;13;14;0
27/10/2019;21:00;161;67;94;Leicht bewölkt;13;13;0
27/10/2019;22:00;131;52;79;Leicht bewölkt;13;13;0
27/10/2019;23:00;70;26;44;Leicht bewölkt;12;13;0
28/10/2019;00:00;54;22;32;Leicht bewölkt;12;12;0
28/10/2019;01:00;25;7;18;Leicht bewölkt;12;12;0
28/10/2019;02:00;9;5;4;Leichter Nebel;12;12;0
28/10/2019;03:00;4;1;3;Leichter Nebel;12;12;0
28/10/2019;04:00;;;;Leichter Nebel;12;12;0
28/10/2019;05:00;51;37;14;Leichter Regenfall;12;12;0
28/10/2019;06:00;161;107;54;Leichter Regenfall;12;12;0
28/10/2019;07:00;471;306;165;Leichter Regenfall;11;11;0
28/10/2019;08:00;450;269;181;Mäßiger Regenfall;10;9;0
28/10/2019;09:00;458;298;160;Mäßiger Regenfall;10;8;1
28/10/2019;10:00;327;203;124;Mäßiger Regenfall;9;8;0
28/10/2019;11:00;450;250;200;Mäßiger Regenfall;9;7;0
28/10/2019;12:00;473;229;244;Mäßiger Regenfall;8;7;1
28/10/2019;13:00;567;298;269;Mäßiger Regenfall;8;7;0
28/10/2019;14:00;503;249;254;Mäßiger Regenfall;8;7;0
28/10/2019;15:00;631;295;336;Mäßiger Regenfall;8;7;0
28/10/2019;16:00;690;313;377;Mäßiger Regenfall;8;7;0
28/10/2019;17:00;792;380;412;Leichter Regenfall;8;6;0
28/10/2019;18:00;643;265;378;Leichter Regenfall;7;6;0
28/10/2019;19:00;523;219;304;Leichter Regenfall;7;5;0
28/10/2019;20:00;337;159;178;Leichter Regenfall;7;5;0
28/10/2019;21:00;239;90;149;Leichter Regenfall;6;5;0
28/10/2019;22:00;194;94;100;Leichter Regenfall;6;5;0
28/10/2019;23:00;81;35;46;Leichter Regenfall;6;5;0
29/10/2019;00:00;52;12;40;Leichter Regenfall;7;5;1
29/10/2019;01:00;23;9;14;Leichter Regenfall;6;5;0
29/10/2019;02:00;14;4;10;Mäßiger Regenfall;6;5;0
29/10/2019;03:00;4;3;1;Mäßiger Regenfall;6;4;0
29/10/2019;04:00;10;7;3;Mäßiger Regenfall;6;4;0
29/10/2019;05:00;41;30;11;Mäßiger Regenfall;6;4;1
29/10/2019;06:00;166;107;59;Mäßiger Regenfall;6;3;1
29/10/2019;07:00;542;378;164;Mäßiger Regenfall;6;3;0
29/10/2019;08:00;549;336;213;Mäßiger Regenfall;6;4;0
29/10/2019;09:00;548;359;189;Mäßiger Regenfall;6;4;1
29/10/2019;10:00;266;162;104;Mäßiger Regenfall;6;4;0
29/10/2019;11:00;370;190;180;Mäßiger Regenfall;6;4;1
29/10/2019;12:00;464;212;252;Mäßiger Regenfall;6;5;1
29/10/2019;13:00;588;298;290;Mäßiger Regenfall;7;5;0
29/10/2019;14:00;457;241;216;Mäßiger Regenfall;7;5;0
29/10/2019;15:00;592;265;327;Mäßiger Regenfall;7;5;0
29/10/2019;16:00;613;293;320;Mäßiger Regenfall;7;5;0
29/10/2019;17:00;766;324;442;Leichter Regenfall;7;5;0
29/10/2019;18:00;535;204;331;Leichter Regenfall;7;5;0
29/10/2019;19:00;431;199;232;Leichter Regenfall;6;4;0
29/10/2019;20:00;322;128;194;Leichter Regenfall;5;4;0
29/10/2019;21:00;237;105;132;Leichter Regenfall;4;3;0
29/10/2019;22:00;202;61;141;Leichter Regenfall;4;3;0
29/10/2019;23:00;109;51;58;Bewölkt;5;4;0
30/10/2019;00:00;38;13;25;Bewölkt;5;4;0
30/10/2019;01:00;24;8;16;Bewölkt;5;4;0
30/10/2019;02:00;19;12;7;Leichter Regenfall;6;4;0
30/10/2019;03:00;11;8;3;Leichter Regenfall;6;4;0
30/10/2019;04:00;17;9;8;Leichter Regenfall;6;3;0
30/10/2019;05:00;53;32;21;Nieselregen;5;3;0
30/10/2019;06:00;155;106;49;Nieselregen;5;3;0
30/10/2019;07:00;559;364;195;Nieselregen;5;3;0
30/10/2019;08:00;578;376;202;Nieselregen;6;4;0
30/10/2019;09:00;651;422;229;Nieselregen;6;4;0
30/10/2019;10:00;449;271;178;Nieselregen;6;5;0
30/10/2019;11:00;563;264;299;Nieselregen;7;5;0
30/10/2019;12:00;583;285;298;Nieselregen;7;6;0
30/10/2019;13:00;670;368;302;Nieselregen;7;6;0
30/10/2019;14:00;502;240;262;Leichter Regenfall;7;6;0
30/10/2019;15:00;542;240;302;Leichter Regenfall;7;7;0
30/10/2019;16:00;574;246;328;Leichter Regenfall;7;6;0
30/10/2019;17:00;734;340;394;Leichter Regenfall;7;6;0
30/10/2019;18:00;606;258;348;Leichter Regenfall;7;6;0
30/10/2019;19:00;436;168;268;Leichter Regenfall;6;5;0
30/10/2019;20:00;252;112;140;Leichter Regenfall;5;5;0
30/10/2019;21:00;201;84;117;Leichter Regenfall;4;4;0
30/10/2019;22:00;203;78;125;Leichter Regenfall;5;5;0
30/10/2019;23:00;98;44;54;Leichter Nebel;5;5;0
31/10/2019;00:00;53;17;36;Leichter Nebel;6;6;0
31/10/2019;01:00;28;6;22;Leichter Nebel;6;5;0
31/10/2019;02:00;15;5;10;Leichter Nebel;6;5;0
31/10/2019;03:00;5;2;3;Leichter Nebel;5;4;0
31/10/2019;04:00;6;4;2;Leichter Nebel;5;4;0
31/10/2019;05:00;38;28;10;Leichter Regenfall;5;3;0
31/10/2019;06:00;168;108;60;Leichter Regenfall;4;2;0
31/10/2019;07:00;533;358;175;Leichter Regenfall;5;3;0
31/10/2019;08:00;649;407;242;Leichter Regenfall;5;4;0
31/10/2019;09:00;708;435;273;Leichter Regenfall;6;5;0
31/10/2019;10:00;465;271;194;Leichter Regenfall;7;6;0
31/10/2019;11:00;630;336;294;Leichter Nebel;8;7;0
31/10/2019;12:00;627;285;342;Leichter Nebel;9;8;0
31/10/2019;13:00;688;340;348;Leichter Nebel;9;8;0
31/10/2019;14:00;633;306;327;Bedeckt;10;9;0
31/10/2019;15:00;803;369;434;Bedeckt;10;9;0
31/10/2019;16:00;827;382;445;Bedeckt;10;9;0
31/10/2019;17:00;896;403;493;Bedeckt;9;8;0
31/10/2019;18:00;725;363;362;Bedeckt;8;8;0
31/10/2019;19:00;495;221;274;Bedeckt;8;7;0
31/10/2019;20:00;455;241;214;Bedeckt;8;7;0
31/10/2019;21:00;315;140;175;Bedeckt;7;7;0
31/10/2019;22:00;244;119;125;Bedeckt;7;7;0
31/10/2019;23:00;257;95;162;Bewölkt;7;7;0
01/11/2019;00:00;187;64;123;Bewölkt;7;7;0
01/11/2019;01:00;148;56;92;Bewölkt;7;7;0
01/11/2019;02:00;147;64;83;Bewölkt;6;6;0
01/11/2019;03:00;137;61;76;Bewölkt;6;6;0
01/11/2019;04:00;86;65;21;Bewölkt;6;6;0
01/11/2019;05:00;62;51;11;Leichter Nebel;6;6;0
01/11/2019;06:00;65;57;8;Leichter Nebel;6;6;0
01/11/2019;07:00;111;85;26;Leichter Nebel;7;7;0
01/11/2019;08:00;122;68;54;Stellenweiser Nieselregen;8;8;0
01/11/2019;09:00;183;103;80;Stellenweiser Nieselregen;9;9;0
01/11/2019;10:00;230;119;111;Stellenweiser Nieselregen;10;10;0
01/11/2019;11:00;251;127;124;Leicht bewölkt;11;11;0
01/11/2019;12:00;290;140;150;Leicht bewölkt;13;13;0
01/11/2019;13:00;322;160;162;Leicht bewölkt;13;13;0
01/11/2019;14:00;385;203;182;Leicht bewölkt;13;13;0
01/11/2019;15:00;336;172;164;Leicht bewölkt;13;13;0
01/11/2019;16:00;326;154;172;Leicht bewölkt;12;12;0
01/11/2019;17:00;292;138;154;Bewölkt;11;11;0
01/11/2019;18:00;264;119;145;Bewölkt;10;10;0
01/11/2019;19:00;306;141;165;Bewölkt;9;9;0
01/11/2019;20:00;179;88;91;Nieselregen;8;8;0
01/11/2019;21:00;104;47;57;Nieselregen;7;7;0
01/11/2019;22:00;120;41;79;Nieselregen;7;7;0
01/11/2019;23:00;148;85;63;Teilweise mäßiger Regenfall;8;7;0
02/11/2019;00:00;81;32;49;Teilweise mäßiger Regenfall;8;7;0
02/11/2019;01:00;63;22;41;Teilweise mäßiger Regenfall;9;8;0
02/11/2019;02:00;18;7;11;Bedeckt;9;8;0
02/11/2019;03:00;14;7;7;Bedeckt;10;9;0
02/11/2019;04:00;2;2;0;Bedeckt;10;9;0
02/11/2019;05:00;20;10;10;Nieselregen;10;9;0
02/11/2019;06:00;28;20;8;Nieselregen;10;9;0
02/11/2019;07:00;67;36;31;Nieselregen;10;10;0
02/11/2019;08:00;155;94;61;Stellenweiser leichter Regenfall;11;11;0
02/11/2019;09:00;342;240;102;Stellenweiser leichter Regenfall;11;11;0
02/11/2019;10:00;585;357;228;Stellenweiser leichter Regenfall;12;11;0
02/11/2019;11:00;669;399;270;Bewölkt;12;12;0
02/11/2019;12:00;722;394;328;Bewölkt;12;12;0
02/11/2019;13:00;639;341;298;Bewölkt;13;12;0
02/11/2019;14:00;704;342;362;Leicht bewölkt;13;13;0
02/11/2019;15:00;648;302;346;Leicht bewölkt;13;13;0
02/11/2019;16:00;615;259;356;Leicht bewölkt;12;12;0
02/11/2019;17:00;557;230;327;Leicht bewölkt;11;11;0
02/11/2019;18:00;471;201;270;Leicht bewölkt;10;10;0
02/11/2019;19:00;360;196;164;Leicht bewölkt;10;9;0
02/11/2019;20:00;271;134;137;Leicht bewölkt;9;9;0
02/11/2019;21:00;227;120;107;Leicht bewölkt;9;8;0
02/11/2019;22:00;221;92;129;Leicht bewölkt;9;9;0
02/11/2019;23:00;223;78;145;Leicht bewölkt;9;9;0
03/11/2019;00:00;121;42;79;Leicht bewölkt;9;9;0
03/11/2019;01:00;139;56;83;Leicht bewölkt;10;10;0
03/11/2019;02:00;98;25;73;Bedeckt;10;10;0
03/11/2019;03:00;47;15;32;Bedeckt;10;10;0
03/11/2019;04:00;16;3;13;Bedeckt;10;10;0
03/11/2019;05:00;20;4;16;Bewölkt;10;9;0
03/11/2019;06:00;28;14;14;Bewölkt;9;9;0
03/11/2019;07:00;48;33;15;Bewölkt;10;9;0
03/11/2019;08:00;68;41;27;Bedeckt;10;10;0
03/11/2019;09:00;160;90;70;Bedeckt;11;10;0
03/11/2019;10:00;206;122;84;Bedeckt;11;11;0
03/11/2019;11:00;232;107;125;Bewölkt;12;11;0
03/11/2019;12:00;243;121;122;Bewölkt;13;12;0
03/11/2019;13:00;216;119;97;Bewölkt;12;12;0
03/11/2019;14:00;333;178;155;Bewölkt;12;12;0
03/11/2019;15:00;294;139;155;Bewölkt;12;12;0
03/11/2019;16:00;244;117;127;Bewölkt;12;11;0
03/11/2019;17:00;223;92;131;Nieselregen;11;10;0
03/11/2019;18:00;198;93;105;Nieselregen;10;10;0
03/11/2019;19:00;171;79;92;Nieselregen;10;9;0
03/11/2019;20:00;134;62;72;Mäßiger Regenfall;10;9;0
03/11/2019;21:00;79;35;44;Mäßiger Regenfall;9;8;0
03/11/2019;22:00;88;39;49;Mäßiger Regenfall;9;7;0
03/11/2019;23:00;52;21;31;Leichter Regenfall;9;7;0
04/11/2019;00:00;23;6;17;Leichter Regenfall;9;6;0
04/11/2019;01:00;15;4;11;Leichter Regenfall;9;6;0
04/11/2019;02:00;2;1;1;Bedeckt;8;6;0
04/11/2019;03:00;2;0;2;Bedeckt;8;5;0
04/11/2019;04:00;10;8;2;Bedeckt;8;5;0
04/11/2019;05:00;51;34;17;Leichter Regenfall;8;5;0
04/11/2019;06:00;210;145;65;Leichter Regenfall;8;5;0
04/11/2019;07:00;1243;790;453;Leichter Regenfall;8;6;0
04/11/2019;08:00;875;514;361;Stellenweiser leichter Regenfall;9;7;0
04/11/2019;09:00;810;503;307;Stellenweiser leichter Regenfall;10;8;0
04/11/2019;10:00;485;273;212;Stellenweiser leichter Regenfall;11;9;0
04/11/2019;11:00;713;317;396;Leicht bewölkt;12;11;0
04/11/2019;12:00;721;327;394;Leicht bewölkt;13;12;0
04/11/2019;13:00;1085;525;560;Leicht bewölkt;13;11;0
04/11/2019;14:00;697;371;326;Leicht bewölkt;12;11;0
04/11/2019;15:00;1134;512;622;Leicht bewölkt;12;11;0
04/11/2019;16:00;1019;460;559;Leicht bewölkt;11;10;0
04/11/2019;17:00;1089;510;579;Stellenweiser Nieselregen;11;9;0
04/11/2019;18:00;831;376;455;Stellenweiser Nieselregen;10;9;0
04/11/2019;19:00;670;305;365;Stellenweiser Nieselregen;10;9;0
04/11/2019;20:00;443;209;234;Bewölkt;9;8;0
04/11/2019;21:00;314;144;170;Bewölkt;9;8;0
04/11/2019;22:00;200;76;124;Bewölkt;9;8;0
04/11/2019;23:00;123;46;77;Leichter Regenfall;8;7;1
05/11/2019;00:00;64;19;45;Leichter Regenfall;8;7;1
05/11/2019;01:00;34;4;30;Leichter Regenfall;8;6;1
05/11/2019;02:00;8;2;6;Mäßiger Regenfall;8;6;0
05/11/2019;03:00;10;4;6;Mäßiger Regenfall;7;6;1
05/11/2019;04:00;13;11;2;Mäßiger Regenfall;7;6;0
05/11/2019;05:00;53;40;13;Mäßiger Regenfall;7;6;0
05/11/2019;06:00;224;144;80;Mäßiger Regenfall;7;6;0
05/11/2019;07:00;1139;658;481;Mäßiger Regenfall;8;7;0
05/11/2019;08:00;927;574;353;Teilweise mäßiger Regenfall;8;7;0
05/11/2019;09:00;772;450;322;Teilweise mäßiger Regenfall;8;8;0
05/11/2019;10:00;571;353;218;Teilweise mäßiger Regenfall;9;8;0
05/11/2019;11:00;688;328;360;Leichter Regenschauer;9;9;0
05/11/2019;12:00;806;352;454;Leichter Regenschauer;10;9;0
05/11/2019;13:00;959;448;511;Leichter Regenschauer;9;8;0
05/11/2019;14:00;751;390;361;Leichter Regenschauer;9;8;0
05/11/2019;15:00;1111;513;598;Leichter Regenschauer;9;7;0
05/11/2019;16:00;1041;497;544;Leichter Regenschauer;8;6;0
05/11/2019;17:00;1180;576;604;Leichter Regenschauer;7;5;0
05/11/2019;18:00;834;370;464;Leichter Regenschauer;6;4;0
05/11/2019;19:00;723;333;390;Leichter Regenschauer;5;4;0
05/11/2019;20:00;446;167;279;Leichter Regenschauer;5;4;0
05/11/2019;21:00;324;113;211;Leichter Regenschauer;5;3;0
05/11/2019;22:00;260;85;175;Leichter Regenschauer;5;4;0
05/11/2019;23:00;150;60;90;Leicht bewölkt;5;4;0
06/11/2019;00:00;62;21;41;Leicht bewölkt;5;4;0
06/11/2019;01:00;32;15;17;Leicht bewölkt;4;4;0
06/11/2019;02:00;6;2;4;Leicht bewölkt;4;3;0
06/11/2019;03:00;0;0;0;Leicht bewölkt;4;3;0
06/11/2019;04:00;12;6;6;Leicht bewölkt;4;3;0
06/11/2019;05:00;52;35;17;Bedeckt;4;3;0
06/11/2019;06:00;179;117;62;Bedeckt;5;3;0
06/11/2019;07:00;1237;788;449;Bedeckt;6;4;0
06/11/2019;08:00;905;542;363;Nieselregen;6;4;0
06/11/2019;09:00;793;522;271;Nieselregen;7;5;0
06/11/2019;10:00;381;211;170;Nieselregen;8;5;0
06/11/2019;11:00;673;324;349;Leichter Regenschauer;8;6;0
06/11/2019;12:00;674;299;375;Leichter Regenschauer;8;6;0
06/11/2019;13:00;986;489;497;Leichter Regenschauer;8;6;0
06/11/2019;14:00;705;354;351;Leichter Regenschauer;8;6;0
06/11/2019;15:00;959;412;547;Leichter Regenschauer;8;6;0
06/11/2019;16:00;930;462;468;Leichter Regenschauer;7;5;0
06/11/2019;17:00;1178;538;640;Leichter Regenschauer;6;4;0
06/11/2019;18:00;942;440;502;Leichter Regenschauer;6;3;0
06/11/2019;19:00;685;307;378;Leichter Regenschauer;5;3;0
06/11/2019;20:00;460;204;256;Bewölkt;4;3;0
06/11/2019;21:00;378;166;212;Bewölkt;4;2;0
06/11/2019;22:00;275;113;162;Bewölkt;4;2;0
06/11/2019;23:00;180;68;112;Leicht bewölkt;4;2;0
07/11/2019;00:00;82;19;63;Leicht bewölkt;4;2;0
07/11/2019;01:00;56;10;46;Leicht bewölkt;3;2;0
07/11/2019;02:00;24;6;18;Leicht bewölkt;3;2;0
07/11/2019;03:00;20;9;11;Leicht bewölkt;3;2;0
07/11/2019;04:00;17;10;7;Leicht bewölkt;3;1;0
07/11/2019;05:00;67;53;14;Leicht bewölkt;2;1;0
07/11/2019;06:00;189;131;58;Leicht bewölkt;2;0;0
07/11/2019;07:00;1245;784;461;Leicht bewölkt;3;1;0
07/11/2019;08:00;955;570;385;Leicht bewölkt;4;3;0
07/11/2019;09:00;890;567;323;Leicht bewölkt;5;4;0
07/11/2019;10:00;495;272;223;Leicht bewölkt;6;5;0
07/11/2019;11:00;666;348;318;Leicht bewölkt;8;7;0
07/11/2019;12:00;739;313;426;Leicht bewölkt;9;8;0
07/11/2019;13:00;1137;483;654;Leicht bewölkt;9;8;0
07/11/2019;14:00;657;295;362;Leicht bewölkt;9;8;0
07/11/2019;15:00;1094;524;570;Leicht bewölkt;8;7;0
07/11/2019;16:00;996;459;537;Leicht bewölkt;7;6;0
07/11/2019;17:00;1136;506;630;Bedeckt;6;5;0
07/11/2019;18:00;921;453;468;Bedeckt;6;4;0
07/11/2019;19:00;642;294;348;Bedeckt;5;4;0
07/11/2019;20:00;440;182;258;Bedeckt;5;4;0
07/11/2019;21:00;317;129;188;Bedeckt;5;4;0
07/11/2019;22:00;268;109;159;Bedeckt;5;4;0
07/11/2019;23:00;149;53;96;Bedeckt;5;4;0
08/11/2019;00:00;86;30;56;Bedeckt;5;4;0
08/11/2019;01:00;33;10;23;Bedeckt;5;4;0
08/11/2019;02:00;18;9;9;Nieselregen;5;4;0
08/11/2019;03:00;12;7;5;Nieselregen;5;4;0
08/11/2019;04:00;9;7;2;Nieselregen;5;4;0
08/11/2019;05:00;45;30;15;Leichter Regenfall;5;3;0
08/11/2019;06:00;167;103;64;Leichter Regenfall;5;3;0
08/11/2019;07:00;1071;680;391;Leichter Regenfall;5;3;0
08/11/2019;08:00;744;460;284;Mäßiger Regenfall;5;3;0
08/11/2019;09:00;634;386;248;Mäßiger Regenfall;5;3;0
08/11/2019;10:00;400;230;170;Mäßiger Regenfall;5;4;0
08/11/2019;11:00;528;263;265;Leichter Regenfall;5;4;0
08/11/2019;12:00;620;263;357;Leichter Regenfall;6;4;0
08/11/2019;13:00;808;266;542;Leichter Regenfall;5;3;0
08/11/2019;14:00;481;225;256;Leichter Regenfall;5;3;0
08/11/2019;15:00;575;233;342;Leichter Regenfall;5;2;0
08/11/2019;16:00;578;282;296;Leichter Regenfall;4;2;0
08/11/2019;17:00;627;316;311;Mäßiger Regenfall;3;1;0
08/11/2019;18:00;548;257;291;Mäßiger Regenfall;2;1;1
08/11/2019;19:00;431;214;217;Mäßiger Regenfall;1;0;0
08/11/2019;20:00;319;167;152;Mäßiger Regenfall;0;-1;0
08/11/2019;21:00;193;103;90;Mäßiger Regenfall;-2;-2;0
08/11/2019;22:00;202;86;116;Mäßiger Regenfall;0;-1;0
08/11/2019;23:00;183;69;114;Nieselregen;1;0;0
09/11/2019;00:00;157;70;87;Nieselregen;2;1;0
09/11/2019;01:00;89;29;60;Nieselregen;3;1;0
09/11/2019;02:00;56;9;47;Leichter Nebel;3;2;0
09/11/2019;03:00;44;11;33;Leichter Nebel;4;2;0
09/11/2019;04:00;20;11;9;Leichter Nebel;4;2;0
09/11/2019;05:00;25;16;9;Leichter Nebel;4;2;0
09/11/2019;06:00;42;28;14;Leichter Nebel;3;2;0
09/11/2019;07:00;88;50;38;Leichter Nebel;4;2;0
09/11/2019;08:00;241;146;95;Leichter Nebel;4;3;0
09/11/2019;09:00;430;303;127;Leichter Nebel;5;3;0
09/11/2019;10:00;523;319;204;Leichter Nebel;5;4;0
09/11/2019;11:00;650;368;282;Leicht bewölkt;6;5;0
09/11/2019;12:00;626;329;297;Leicht bewölkt;7;6;0
09/11/2019;13:00;663;327;336;Leicht bewölkt;7;6;0
09/11/2019;14:00;649;317;332;Leicht bewölkt;7;6;0
09/11/2019;15:00;665;317;348;Leicht bewölkt;7;7;0
09/11/2019;16:00;610;271;339;Leicht bewölkt;6;6;0
09/11/2019;17:00;708;344;364;Leicht bewölkt;5;5;0
09/11/2019;18:00;537;247;290;Leicht bewölkt;4;4;0
09/11/2019;19:00;461;279;182;Leicht bewölkt;3;2;0
09/11/2019;20:00;357;168;189;Leicht bewölkt;2;1;0
09/11/2019;21:00;294;141;153;Leicht bewölkt;1;0;0
09/11/2019;22:00;245;118;127;Leicht bewölkt;1;0;0
09/11/2019;23:00;166;61;105;Leicht bewölkt;1;0;0
10/11/2019;00:00;184;68;116;Leicht bewölkt;0;0;0
10/11/2019;01:00;161;51;110;Leicht bewölkt;0;0;0
10/11/2019;02:00;101;28;73;Leicht bewölkt;0;0;0
10/11/2019;03:00;84;23;61;Leicht bewölkt;0;0;0
10/11/2019;04:00;43;11;32;Leicht bewölkt;0;0;0
10/11/2019;05:00;20;11;9;Leicht bewölkt;0;0;0
10/11/2019;06:00;42;23;19;Leicht bewölkt;-1;-1;0
10/11/2019;07:00;51;32;19;Leicht bewölkt;1;1;0
10/11/2019;08:00;93;49;44;Leicht bewölkt;2;2;0
10/11/2019;09:00;179;108;71;Leicht bewölkt;3;3;0
10/11/2019;10:00;233;123;110;Leicht bewölkt;5;5;0
10/11/2019;11:00;273;138;135;Leicht bewölkt;6;6;0
10/11/2019;12:00;278;134;144;Leicht bewölkt;8;8;0
10/11/2019;13:00;295;146;149;Leicht bewölkt;8;8;0
10/11/2019;14:00;473;212;261;Leicht bewölkt;8;8;0
10/11/2019;15:00;435;229;206;Leicht bewölkt;7;7;0
10/11/2019;16:00;427;214;213;Leicht bewölkt;6;6;0
10/11/2019;17:00;400;206;194;Leicht bewölkt;5;5;0
10/11/2019;18:00;303;140;163;Leicht bewölkt;4;4;0
10/11/2019;19:00;258;141;117;Leicht bewölkt;3;3;0
10/11/2019;20:00;170;69;101;Leicht bewölkt;2;2;0
10/11/2019;21:00;137;60;77;Leicht bewölkt;1;1;0
10/11/2019;22:00;139;45;94;Leicht bewölkt;0;0;0
10/11/2019;23:00;63;21;42;Leicht bewölkt;0;0;0
11/11/2019;00:00;34;12;22;Leicht bewölkt;-1;-1;0
11/11/2019;01:00;12;7;5;Leicht bewölkt;0;0;0
11/11/2019;02:00;9;5;4;Leicht bewölkt;0;0;0
11/11/2019;03:00;1;1;0;Leicht bewölkt;0;0;0
11/11/2019;04:00;10;7;3;Leicht bewölkt;0;0;0
11/11/2019;05:00;62;51;11;Leicht bewölkt;0;0;0
11/11/2019;06:00;179;129;50;Leicht bewölkt;-1;-1;0
11/11/2019;07:00;1246;811;435;Leicht bewölkt;1;1;0
11/11/2019;08:00;832;467;365;Leicht bewölkt;2;2;0
11/11/2019;09:00;818;511;307;Leicht bewölkt;3;3;0
11/11/2019;10:00;431;233;198;Leicht bewölkt;4;4;0
11/11/2019;11:00;636;301;335;Leicht bewölkt;5;5;0
11/11/2019;12:00;673;322;351;Leicht bewölkt;6;6;0
11/11/2019;13:00;1007;475;532;Leicht bewölkt;6;6;0
11/11/2019;14:00;749;363;386;Leicht bewölkt;6;6;0
11/11/2019;15:00;1073;478;595;Leicht bewölkt;6;6;0
11/11/2019;16:00;1001;419;582;Leicht bewölkt;6;5;0
11/11/2019;17:00;1069;494;575;Leicht bewölkt;5;4;0
11/11/2019;18:00;861;402;459;Leicht bewölkt;4;3;0
11/11/2019;19:00;732;350;382;Leicht bewölkt;3;2;0
11/11/2019;20:00;428;206;222;Bedeckt;3;2;0
11/11/2019;21:00;301;119;182;Bedeckt;2;1;0
11/11/2019;22:00;233;99;134;Bedeckt;2;2;0
11/11/2019;23:00;114;35;79;Leichter Regenfall;3;2;0
12/11/2019;00:00;50;21;29;Leichter Regenfall;3;2;0
12/11/2019;01:00;27;8;19;Leichter Regenfall;4;2;0
12/11/2019;02:00;10;5;5;Nieselregen;4;2;0
12/11/2019;03:00;3;1;2;Nieselregen;4;2;0
12/11/2019;04:00;10;9;1;Nieselregen;4;1;0
12/11/2019;05:00;71;52;19;Leichter Regenfall;3;1;0
12/11/2019;06:00;195;133;62;Leichter Regenfall;3;1;0
12/11/2019;07:00;1270;825;445;Leichter Regenfall;3;1;0
12/11/2019;08:00;940;567;373;Stellenweiser Eisregen;4;2;0
12/11/2019;09:00;844;557;287;Stellenweiser Eisregen;4;2;0
12/11/2019;10:00;531;309;222;Stellenweiser Eisregen;5;3;0
12/11/2019;11:00;716;339;377;Bedeckt;5;3;0
12/11/2019;12:00;761;275;486;Bedeckt;6;4;0
12/11/2019;13:00;1021;477;544;Bedeckt;6;4;0
12/11/2019;14:00;738;353;385;Leicht bewölkt;6;5;0
12/11/2019;15:00;1143;528;615;Leicht bewölkt;6;5;0
12/11/2019;16:00;934;433;501;Leicht bewölkt;5;5;0
12/11/2019;17:00;1231;554;677;Leicht bewölkt;4;4;0
12/11/2019;18:00;938;432;506;Leicht bewölkt;3;3;0
12/11/2019;19:00;789;354;435;Leicht bewölkt;2;2;0
12/11/2019;20:00;423;189;234;Bewölkt;1;1;0
12/11/2019;21:00;335;127;208;Bewölkt;0;0;0
12/11/2019;22:00;300;106;194;Bewölkt;1;1;0
12/11/2019;23:00;137;63;74;Leichter Eisregen;1;1;0
13/11/2019;00:00;42;18;24;Leichter Eisregen;2;1;0
13/11/2019;01:00;32;11;21;Leichter Eisregen;2;1;0
13/11/2019;02:00;12;4;8;Leichter Nebel;2;2;0
13/11/2019;03:00;4;0;4;Leichter Nebel;3;2;0
13/11/2019;04:00;10;9;1;Leichter Nebel;3;1;0
13/11/2019;05:00;69;50;19;Leichter Eisregen;2;1;0
13/11/2019;06:00;194;131;63;Leichter Eisregen;2;1;0
13/11/2019;07:00;1316;878;438;Leichter Eisregen;3;1;0
13/11/2019;08:00;937;596;341;Mäßige bis starke Schneefälle;3;1;0
13/11/2019;09:00;846;555;291;Mäßige bis starke Schneefälle;3;2;0
13/11/2019;10:00;535;311;224;Mäßige bis starke Schneefälle;4;2;0
13/11/2019;11:00;693;337;356;Stellenweiser Regenfall;4;2;0
13/11/2019;12:00;771;344;427;Stellenweiser Regenfall;5;3;0
13/11/2019;13:00;1038;482;556;Stellenweiser Regenfall;5;3;0
13/11/2019;14:00;749;354;395;Stellenweiser Regenfall;5;3;0
13/11/2019;15:00;1031;436;595;Stellenweiser Regenfall;5;3;0
13/11/2019;16:00;942;450;492;Stellenweiser Regenfall;4;2;0
13/11/2019;17:00;1116;494;622;Leicht bewölkt;3;2;0
13/11/2019;18:00;921;408;513;Leicht bewölkt;2;1;0
13/11/2019;19:00;689;308;381;Leicht bewölkt;1;0;0
13/11/2019;20:00;517;253;264;Leicht bewölkt;0;-1;0
13/11/2019;21:00;340;144;196;Leicht bewölkt;0;-2;0
13/11/2019;22:00;273;108;165;Leicht bewölkt;0;-2;0
13/11/2019;23:00;180;70;110;Leicht bewölkt;0;-2;0
14/11/2019;00:00;76;32;44;Leicht bewölkt;-1;-2;0
14/11/2019;01:00;39;15;24;Leicht bewölkt;-1;-3;0
14/11/2019;02:00;34;14;20;Leicht bewölkt;-1;-3;0
14/11/2019;03:00;21;13;8;Leicht bewölkt;-2;-3;0
14/11/2019;04:00;39;28;11;Leicht bewölkt;-2;-3;0
14/11/2019;05:00;69;56;13;Leicht bewölkt;-2;-3;0
14/11/2019;06:00;183;119;64;Leicht bewölkt;-2;-3;0
14/11/2019;07:00;1170;764;406;Leicht bewölkt;-1;-2;0
14/11/2019;08:00;952;589;363;Leicht bewölkt;1;0;0
14/11/2019;09:00;787;495;292;Leicht bewölkt;2;2;0
14/11/2019;10:00;508;315;193;Leicht bewölkt;3;3;0
14/11/2019;11:00;696;331;365;Leicht bewölkt;5;4;0
14/11/2019;12:00;705;308;397;Leicht bewölkt;6;6;0
14/11/2019;13:00;1026;454;572;Leicht bewölkt;6;5;0
14/11/2019;14:00;701;332;369;Leicht bewölkt;6;5;0
14/11/2019;15:00;1151;563;588;Leicht bewölkt;6;4;0
14/11/2019;16:00;948;450;498;Leicht bewölkt;5;4;0
14/11/2019;17:00;1189;513;676;Leicht bewölkt;5;3;0
14/11/2019;18:00;892;403;489;Leicht bewölkt;4;3;0
14/11/2019;19:00;651;338;313;Leicht bewölkt;3;3;0
14/11/2019;20:00;424;172;252;Leicht bewölkt;3;2;0
14/11/2019;21:00;348;126;222;Leicht bewölkt;2;2;0
14/11/2019;22:00;259;98;161;Leicht bewölkt;1;1;0
14/11/2019;23:00;169;65;104;Bedeckt;1;1;0
15/11/2019;00:00;102;39;63;Bedeckt;0;0;0
15/11/2019;01:00;52;9;43;Bedeckt;1;0;0
15/11/2019;02:00;21;15;6;Leicht bewölkt;1;0;0
15/11/2019;03:00;18;6;12;Leicht bewölkt;1;0;0
15/11/2019;04:00;15;11;4;Leicht bewölkt;1;-1;0
15/11/2019;05:00;48;39;9;Leicht bewölkt;1;-1;0
15/11/2019;06:00;181;109;72;Leicht bewölkt;1;-2;0
15/11/2019;07:00;1071;703;368;Leicht bewölkt;2;-2;0
15/11/2019;08:00;778;503;275;Leicht bewölkt;2;-1;0
15/11/2019;09:00;622;376;246;Leicht bewölkt;3;-1;0
15/11/2019;10:00;431;259;172;Leicht bewölkt;4;0;0
15/11/2019;11:00;591;356;235;Nieselregen;5;2;0
15/11/2019;12:00;736;305;431;Nieselregen;6;3;0
15/11/2019;13:00;1047;433;614;Nieselregen;6;3;0
15/11/2019;14:00;741;359;382;Stellenweiser Nieselregen;6;4;0
15/11/2019;15:00;833;427;406;Stellenweiser Nieselregen;6;4;0
15/11/2019;16:00;850;414;436;Stellenweiser Nieselregen;5;4;0
15/11/2019;17:00;810;373;437;Bedeckt;5;3;0
15/11/2019;18:00;638;321;317;Bedeckt;4;3;0
15/11/2019;19:00;497;247;250;Bedeckt;4;3;0
15/11/2019;20:00;361;178;183;Nieselregen;4;2;0
15/11/2019;21:00;238;98;140;Nieselregen;3;2;0
15/11/2019;22:00;264;110;154;Nieselregen;3;2;0
15/11/2019;23:00;158;50;108;Leichter Regenfall;3;2;0
16/11/2019;00:00;138;47;91;Leichter Regenfall;3;3;1
16/11/2019;01:00;87;29;58;Leichter Regenfall;3;3;0
16/11/2019;02:00;77;34;43;Mäßiger Regenfall;3;3;0
16/11/2019;03:00;33;9;24;Mäßiger Regenfall;3;3;0
16/11/2019;04:00;30;15;15;Mäßiger Regenfall;3;3;0
16/11/2019;05:00;36;25;11;Leicht bewölkt;3;2;0
16/11/2019;06:00;33;27;6;Leicht bewölkt;2;2;0
16/11/2019;07:00;91;56;35;Leicht bewölkt;3;2;0
16/11/2019;08:00;225;125;100;Leicht bewölkt;3;3;0
16/11/2019;09:00;385;258;127;Leicht bewölkt;4;3;0
16/11/2019;10:00;473;299;174;Leicht bewölkt;5;4;0
16/11/2019;11:00;629;374;255;Bedeckt;5;5;0
16/11/2019;12:00;742;401;341;Bedeckt;6;6;0
16/11/2019;13:00;700;343;357;Bedeckt;6;6;0
16/11/2019;14:00;608;308;300;Bewölkt;7;6;0
16/11/2019;15:00;576;283;293;Bewölkt;7;6;0
16/11/2019;16:00;565;243;322;Bewölkt;6;5;0
16/11/2019;17:00;543;282;261;Bewölkt;5;4;0
16/11/2019;18:00;472;219;253;Bewölkt;5;4;0
16/11/2019;19:00;355;190;165;Bewölkt;4;3;0
16/11/2019;20:00;324;173;151;Leicht bewölkt;4;2;0
16/11/2019;21:00;200;91;109;Leicht bewölkt;3;2;0
16/11/2019;22:00;182;75;107;Leicht bewölkt;3;2;0
16/11/2019;23:00;217;89;128;Bewölkt;3;2;0
17/11/2019;00:00;182;70;112;Bewölkt;3;2;0
17/11/2019;01:00;142;52;90;Bewölkt;3;2;0
17/11/2019;02:00;71;26;45;Bedeckt;3;2;0
17/11/2019;03:00;50;29;21;Bedeckt;3;2;0
17/11/2019;04:00;24;9;15;Bedeckt;3;2;0
17/11/2019;05:00;26;9;17;Stellenweiser Regenfall;3;2;0
17/11/2019;06:00;26;19;7;Stellenweiser Regenfall;3;2;0
17/11/2019;07:00;36;21;15;Stellenweiser Regenfall;3;2;0
17/11/2019;08:00;64;34;30;Leichter Eisregen;4;3;0
17/11/2019;09:00;127;78;49;Leichter Eisregen;4;3;0
17/11/2019;10:00;122;71;51;Leichter Eisregen;4;4;0
17/11/2019;11:00;162;89;73;Nieselregen;5;4;0
17/11/2019;12:00;222;125;97;Nieselregen;5;5;0
17/11/2019;13:00;154;68;86;Nieselregen;5;4;0
17/11/2019;14:00;250;108;142;Leichter Regenfall;5;3;0
17/11/2019;15:00;248;127;121;Leichter Regenfall;5;3;0
17/11/2019;16:00;307;136;171;Leichter Regenfall;4;2;0
17/11/2019;17:00;283;134;149;Nieselregen;4;1;0
17/11/2019;18:00;260;142;118;Nieselregen;4;0;0
17/11/2019;19:00;200;101;99;Nieselregen;4;0;0
17/11/2019;20:00;150;69;81;Leichter Regenfall;3;0;0
17/11/2019;21:00;112;49;63;Leichter Regenfall;3;0;0
17/11/2019;22:00;83;38;45;Leichter Regenfall;3;0;0
17/11/2019;23:00;43;11;32;Bewölkt;3;1;0
18/11/2019;00:00;35;16;19;Bewölkt;3;1;0
18/11/2019;01:00;10;4;6;Bewölkt;3;1;0
18/11/2019;02:00;2;1;1;Bewölkt;3;1;0
18/11/2019;03:00;2;2;0;Bewölkt;3;1;0
18/11/2019;04:00;11;6;5;Bewölkt;3;1;0
18/11/2019;05:00;61;48;13;Bedeckt;3;0;0
18/11/2019;06:00;193;137;56;Bedeckt;3;0;0
18/11/2019;07:00;1165;766;399;Bedeckt;3;0;0
18/11/2019;08:00;877;516;361;Leichter Schneefall;3;0;0
18/11/2019;09:00;837;545;292;Leichter Schneefall;3;0;0
18/11/2019;10:00;488;270;218;Leichter Schneefall;4;0;0
18/11/2019;11:00;621;308;313;Bedeckt;4;1;0
18/11/2019;12:00;678;300;378;Bedeckt;5;1;0
18/11/2019;13:00;998;428;570;Bedeckt;5;2;0
18/11/2019;14:00;610;298;312;Stellenweiser Regenfall;5;2;0
18/11/2019;15:00;1019;474;545;Stellenweiser Regenfall;5;3;0
18/11/2019;16:00;968;453;515;Stellenweiser Regenfall;4;2;0
18/11/2019;17:00;1127;541;586;Stellenweiser Regenfall;4;2;0
18/11/2019;18:00;867;405;462;Stellenweiser Regenfall;3;1;0
18/11/2019;19:00;707;311;396;Stellenweiser Regenfall;2;1;0
18/11/2019;20:00;427;211;216;Stellenweiser Regenfall;2;1;0
18/11/2019;21:00;336;139;197;Stellenweiser Regenfall;2;1;0
18/11/2019;22:00;239;94;145;Stellenweiser Regenfall;1;1;0
18/11/2019;23:00;147;46;101;Bedeckt;1;1;0
19/11/2019;00:00;49;24;25;Bedeckt;1;1;0
19/11/2019;01:00;12;7;5;Bedeckt;1;1;0
19/11/2019;02:00;2;1;1;Leicht bewölkt;1;1;0
19/11/2019;03:00;3;1;2;Leicht bewölkt;0;0;0
19/11/2019;04:00;15;13;2;Leicht bewölkt;0;0;0
19/11/2019;05:00;55;44;11;Leicht bewölkt;0;0;0
19/11/2019;06:00;186;120;66;Leicht bewölkt;0;-1;0
19/11/2019;07:00;1281;848;433;Leicht bewölkt;1;0;0
19/11/2019;08:00;938;576;362;Leicht bewölkt;2;1;0
19/11/2019;09:00;830;540;290;Leicht bewölkt;3;2;0
19/11/2019;10:00;511;309;202;Leicht bewölkt;3;3;0
19/11/2019;11:00;665;337;328;Leicht bewölkt;4;4;0
19/11/2019;12:00;753;298;455;Leicht bewölkt;5;5;0
19/11/2019;13:00;995;463;532;Leicht bewölkt;6;5;0
19/11/2019;14:00;671;315;356;Leicht bewölkt;6;5;0
19/11/2019;15:00;1111;492;619;Leicht bewölkt;6;5;0
19/11/2019;16:00;967;458;509;Leicht bewölkt;5;5;0
19/11/2019;17:00;1164;516;648;Bedeckt;5;4;0
19/11/2019;18:00;882;387;495;Bedeckt;5;4;0
19/11/2019;19:00;751;346;405;Bedeckt;4;3;0
19/11/2019;20:00;427;206;221;Bedeckt;4;3;0
19/11/2019;21:00;310;111;199;Bedeckt;4;3;0
19/11/2019;22:00;304;92;212;Bedeckt;4;2;0
19/11/2019;23:00;135;49;86;Bedeckt;4;2;0
20/11/2019;00:00;64;15;49;Bedeckt;4;2;0
20/11/2019;01:00;61;24;37;Bedeckt;4;2;0
20/11/2019;02:00;14;3;11;Bewölkt;3;1;0
20/11/2019;03:00;6;4;2;Bewölkt;3;1;0
20/11/2019;04:00;10;7;3;Bewölkt;2;0;0
20/11/2019;05:00;60;42;18;Bewölkt;2;0;0
20/11/2019;06:00;205;140;65;Bewölkt;1;0;0
20/11/2019;07:00;1179;765;414;Bewölkt;2;0;0
20/11/2019;08:00;930;554;376;Leichter Nebel;2;1;0
20/11/2019;09:00;885;584;301;Leichter Nebel;3;2;0
20/11/2019;10:00;456;280;176;Leichter Nebel;4;4;0
20/11/2019;11:00;657;303;354;Leicht bewölkt;5;5;0
20/11/2019;12:00;740;334;406;Leicht bewölkt;7;6;0
20/11/2019;13:00;1053;541;512;Leicht bewölkt;6;6;0
20/11/2019;14:00;674;328;346;Leicht bewölkt;6;6;0
20/11/2019;15:00;1008;437;571;Leicht bewölkt;6;6;0
20/11/2019;16:00;891;419;472;Leicht bewölkt;5;5;0
20/11/2019;17:00;1081;503;578;Leicht bewölkt;4;4;0
20/11/2019;18:00;967;444;523;Leicht bewölkt;3;3;0
20/11/2019;19:00;702;336;366;Leicht bewölkt;2;2;0
20/11/2019;20:00;513;246;267;Leicht bewölkt;2;2;0
20/11/2019;21:00;343;151;192;Leicht bewölkt;1;1;0
20/11/2019;22:00;234;97;137;Leicht bewölkt;1;1;0
20/11/2019;23:00;212;65;147;Leichter Nebel;1;1;0
21/11/2019;00:00;103;34;69;Leichter Nebel;1;1;0
21/11/2019;01:00;46;9;37;Leichter Nebel;1;1;0
21/11/2019;02:00;18;8;10;Leichter Nebel;1;1;0
21/11/2019;03:00;11;5;6;Leichter Nebel;1;1;0
21/11/2019;04:00;11;4;7;Leichter Nebel;1;1;0
21/11/2019;05:00;61;47;14;Bedeckt;1;1;0
21/11/2019;06:00;189;129;60;Bedeckt;1;1;0
21/11/2019;07:00;1195;766;429;Bedeckt;2;2;0
21/11/2019;08:00;939;574;365;Leichter Nebel;3;3;0
21/11/2019;09:00;761;499;262;Leichter Nebel;3;3;0
21/11/2019;10:00;500;310;190;Leichter Nebel;4;4;0
21/11/2019;11:00;665;333;332;Bewölkt;5;5;0
21/11/2019;12:00;713;310;403;Bewölkt;6;6;0
21/11/2019;13:00;1032;437;595;Bewölkt;6;6;0
21/11/2019;14:00;678;333;345;Leicht bewölkt;6;6;0
21/11/2019;15:00;992;489;503;Leicht bewölkt;6;6;0
21/11/2019;16:00;927;441;486;Leicht bewölkt;5;5;0
21/11/2019;17:00;1128;534;594;Leicht bewölkt;4;4;0
21/11/2019;18:00;894;421;473;Leicht bewölkt;3;3;0
21/11/2019;19:00;707;338;369;Leicht bewölkt;3;2;0
21/11/2019;20:00;468;241;227;Leicht bewölkt;2;2;0
21/11/2019;21:00;377;167;210;Leicht bewölkt;1;1;0
21/11/2019;22:00;328;168;160;Leicht bewölkt;1;1;0
21/11/2019;23:00;190;67;123;Leicht bewölkt;0;0;0
22/11/2019;00:00;101;27;74;Leicht bewölkt;0;0;0
22/11/2019;01:00;78;6;72;Leicht bewölkt;0;0;0
22/11/2019;02:00;59;3;56;Leicht bewölkt;0;0;0
22/11/2019;03:00;38;3;35;Leicht bewölkt;0;0;0
22/11/2019;04:00;18;10;8;Leicht bewölkt;0;0;0
22/11/2019;05:00;46;32;14;Bewölkt;0;0;0
22/11/2019;06:00;174;110;64;Bewölkt;0;0;0
22/11/2019;07:00;1046;681;365;Bewölkt;1;1;0
22/11/2019;08:00;859;556;303;Leicht bewölkt;2;2;0
22/11/2019;09:00;813;521;292;Leicht bewölkt;3;3;0
22/11/2019;10:00;562;331;231;Leicht bewölkt;4;4;0
22/11/2019;11:00;698;360;338;Leicht bewölkt;6;6;0
22/11/2019;12:00;809;356;453;Leicht bewölkt;7;7;0
22/11/2019;13:00;1090;435;655;Leicht bewölkt;7;7;0
22/11/2019;14:00;766;377;389;Leicht bewölkt;7;7;0
22/11/2019;15:00;863;413;450;Leicht bewölkt;7;6;0
22/11/2019;16:00;829;382;447;Leicht bewölkt;6;5;0
22/11/2019;17:00;845;389;456;Leicht bewölkt;5;4;0
22/11/2019;18:00;754;372;382;Leicht bewölkt;4;3;0
22/11/2019;19:00;554;285;269;Leicht bewölkt;4;3;0
22/11/2019;20:00;397;197;200;Leicht bewölkt;3;2;0
22/11/2019;21:00;280;127;153;Leicht bewölkt;3;2;0
22/11/2019;22:00;301;130;171;Leicht bewölkt;3;2;0
22/11/2019;23:00;195;76;119;Leicht bewölkt;3;2;0
23/11/2019;00:00;157;64;93;Leicht bewölkt;3;2;0
23/11/2019;01:00;118;42;76;Leicht bewölkt;3;1;0
23/11/2019;02:00;81;26;55;Leicht bewölkt;3;1;0
23/11/2019;03:00;46;21;25;Leicht bewölkt;3;1;0
23/11/2019;04:00;31;19;12;Leicht bewölkt;3;1;0
23/11/2019;05:00;24;13;11;Leicht bewölkt;3;1;0
23/11/2019;06:00;44;34;10;Leicht bewölkt;3;1;0
23/11/2019;07:00;86;55;31;Leicht bewölkt;4;2;0
23/11/2019;08:00;267;155;112;Leicht bewölkt;5;3;0
23/11/2019;09:00;413;255;158;Leicht bewölkt;6;5;0
23/11/2019;10:00;526;320;206;Leicht bewölkt;8;7;0
23/11/2019;11:00;609;347;262;Leicht bewölkt;10;9;0
23/11/2019;12:00;644;362;282;Leicht bewölkt;12;11;0
23/11/2019;13:00;677;362;315;Leicht bewölkt;11;11;0
23/11/2019;14:00;651;330;321;Leicht bewölkt;11;10;0
23/11/2019;15:00;552;245;307;Leicht bewölkt;11;10;0
23/11/2019;16:00;546;228;318;Leicht bewölkt;10;9;0
23/11/2019;17:00;566;231;335;Leicht bewölkt;9;8;0
23/11/2019;18:00;471;233;238;Leicht bewölkt;8;7;0
23/11/2019;19:00;486;311;175;Leicht bewölkt;8;7;0
23/11/2019;20:00;299;150;149;Leicht bewölkt;7;6;0
23/11/2019;21:00;293;105;188;Leicht bewölkt;7;6;0
23/11/2019;22:00;266;105;161;Leicht bewölkt;6;6;0
23/11/2019;23:00;210;67;143;Leicht bewölkt;6;6;0
24/11/2019;00:00;174;52;122;Leicht bewölkt;6;6;0
24/11/2019;01:00;155;58;97;Leicht bewölkt;6;5;0
24/11/2019;02:00;98;40;58;Leicht bewölkt;5;5;0
24/11/2019;03:00;54;23;31;Leicht bewölkt;5;5;0
24/11/2019;04:00;25;16;9;Leicht bewölkt;5;4;0
24/11/2019;05:00;36;23;13;Leicht bewölkt;4;4;0
24/11/2019;06:00;37;29;8;Leicht bewölkt;4;4;0
24/11/2019;07:00;40;24;16;Leicht bewölkt;5;5;0
24/11/2019;08:00;79;40;39;Leicht bewölkt;6;6;0
24/11/2019;09:00;223;133;90;Leicht bewölkt;7;7;0
24/11/2019;10:00;255;150;105;Leicht bewölkt;8;8;0
24/11/2019;11:00;333;180;153;Leicht bewölkt;9;9;0
24/11/2019;12:00;422;234;188;Leicht bewölkt;10;10;0
24/11/2019;13:00;442;232;210;Leicht bewölkt;10;9;0
24/11/2019;14:00;468;270;198;Leicht bewölkt;9;9;0
24/11/2019;15:00;444;242;202;Leicht bewölkt;9;8;0
24/11/2019;16:00;546;271;275;Leicht bewölkt;8;7;0
24/11/2019;17:00;418;180;238;Leicht bewölkt;7;6;0
24/11/2019;18:00;350;139;211;Leicht bewölkt;6;6;0
24/11/2019;19:00;268;121;147;Leicht bewölkt;5;5;0
24/11/2019;20:00;179;86;93;Leicht bewölkt;5;5;0
24/11/2019;21:00;153;65;88;Leicht bewölkt;4;4;0
24/11/2019;22:00;148;74;74;Leicht bewölkt;4;4;0
24/11/2019;23:00;70;36;34;Leicht bewölkt;4;4;0
25/11/2019;00:00;40;17;23;Leicht bewölkt;4;4;0
25/11/2019;01:00;16;4;12;Leicht bewölkt;4;4;0
25/11/2019;02:00;7;2;5;Leichter Nebel;5;5;0
25/11/2019;03:00;6;1;5;Leichter Nebel;5;5;0
25/11/2019;04:00;10;9;1;Leichter Nebel;5;5;0
25/11/2019;05:00;57;43;14;Leichter Nebel;5;5;0
25/11/2019;06:00;187;124;63;Leichter Nebel;5;5;0
25/11/2019;07:00;1184;792;392;Leichter Nebel;6;6;0
25/11/2019;08:00;811;473;338;Bedeckt;6;6;0
25/11/2019;09:00;849;543;306;Bedeckt;7;7;0
25/11/2019;10:00;464;259;205;Bedeckt;7;7;0
25/11/2019;11:00;612;294;318;Bewölkt;8;8;0
25/11/2019;12:00;674;317;357;Bewölkt;8;8;0
25/11/2019;13:00;957;442;515;Bewölkt;8;8;0
25/11/2019;14:00;689;357;332;Bewölkt;8;8;0
25/11/2019;15:00;1069;502;567;Bewölkt;8;8;0
25/11/2019;16:00;874;402;472;Bewölkt;8;8;0
25/11/2019;17:00;1083;533;550;Leicht bewölkt;7;7;0
25/11/2019;18:00;918;419;499;Leicht bewölkt;6;6;0
25/11/2019;19:00;710;280;430;Leicht bewölkt;6;6;0
25/11/2019;20:00;440;185;255;Leicht bewölkt;6;6;0
25/11/2019;21:00;311;145;166;Leicht bewölkt;6;6;0
25/11/2019;22:00;225;101;124;Leicht bewölkt;6;6;0
25/11/2019;23:00;121;44;77;Leicht bewölkt;6;6;0
26/11/2019;00:00;63;21;42;Leicht bewölkt;6;6;0
26/11/2019;01:00;28;6;22;Leicht bewölkt;6;5;0
26/11/2019;02:00;8;3;5;Bewölkt;5;5;0
26/11/2019;03:00;5;2;3;Bewölkt;5;5;0
26/11/2019;04:00;9;7;2;Bewölkt;5;5;0
26/11/2019;05:00;51;38;13;Bewölkt;5;5;0
26/11/2019;06:00;203;146;57;Bewölkt;4;4;0
26/11/2019;07:00;1246;839;407;Bewölkt;5;5;0
26/11/2019;08:00;943;562;381;Leicht bewölkt;6;6;0
26/11/2019;09:00;879;597;282;Leicht bewölkt;7;6;0
26/11/2019;10:00;493;308;185;Leicht bewölkt;8;7;0
26/11/2019;11:00;872;522;350;Leicht bewölkt;9;8;0
26/11/2019;12:00;943;501;442;Leicht bewölkt;10;9;0
26/11/2019;13:00;1028;450;578;Leicht bewölkt;9;9;0
26/11/2019;14:00;979;341;638;Leicht bewölkt;9;9;0
26/11/2019;15:00;1034;434;600;Leicht bewölkt;9;9;0
26/11/2019;16:00;956;435;521;Leicht bewölkt;8;8;0
26/11/2019;17:00;1069;502;567;Leicht bewölkt;7;7;0
26/11/2019;18:00;950;389;561;Leicht bewölkt;6;6;0
26/11/2019;19:00;768;326;442;Leicht bewölkt;6;6;0
26/11/2019;20:00;479;233;246;Leicht bewölkt;5;5;0
26/11/2019;21:00;288;115;173;Leicht bewölkt;5;5;0
26/11/2019;22:00;265;108;157;Leicht bewölkt;5;5;0
26/11/2019;23:00;170;65;105;Leicht bewölkt;5;4;0
27/11/2019;00:00;73;23;50;Leicht bewölkt;5;4;0
27/11/2019;01:00;36;13;23;Leicht bewölkt;5;4;0
27/11/2019;02:00;9;4;5;Leicht bewölkt;5;4;0
27/11/2019;03:00;1;0;1;Leicht bewölkt;5;4;0
27/11/2019;04:00;6;3;3;Leicht bewölkt;5;4;0
27/11/2019;05:00;67;47;20;Bewölkt;6;4;0
27/11/2019;06:00;183;123;60;Bewölkt;6;5;0
27/11/2019;07:00;1243;828;415;Bewölkt;7;5;0
27/11/2019;08:00;798;492;306;Bedeckt;8;6;0
27/11/2019;09:00;605;385;220;Bedeckt;8;7;0
27/11/2019;10:00;334;199;135;Bedeckt;9;7;0
27/11/2019;11:00;606;303;303;Nieselregen;9;7;0
27/11/2019;12:00;678;311;367;Nieselregen;9;8;0
27/11/2019;13:00;993;524;469;Nieselregen;9;8;0
27/11/2019;14:00;663;344;319;Leicht bewölkt;9;8;0
27/11/2019;15:00;1000;448;552;Leicht bewölkt;9;8;0
27/11/2019;16:00;915;418;497;Leicht bewölkt;9;7;0
27/11/2019;17:00;1106;463;643;Stellenweiser Regenfall;8;7;0
27/11/2019;18:00;888;386;502;Stellenweiser Regenfall;8;7;0
27/11/2019;19:00;665;288;377;Stellenweiser Regenfall;7;6;0
27/11/2019;20:00;474;189;285;Leicht bewölkt;7;5;0
27/11/2019;21:00;343;138;205;Leicht bewölkt;6;5;0
27/11/2019;22:00;250;108;142;Leicht bewölkt;7;5;0
27/11/2019;23:00;184;65;119;Leichter Regenschauer;7;5;0
28/11/2019;00:00;85;29;56;Leichter Regenschauer;7;5;0
28/11/2019;01:00;39;13;26;Leichter Regenschauer;7;5;0
28/11/2019;02:00;18;8;10;Leichter Regenschauer;7;5;0
28/11/2019;03:00;15;10;5;Leichter Regenschauer;7;5;0
28/11/2019;04:00;12;7;5;Leichter Regenschauer;7;5;0
28/11/2019;05:00;39;29;10;Leicht bewölkt;7;4;0
28/11/2019;06:00;191;134;57;Leicht bewölkt;7;4;0
28/11/2019;07:00;1158;730;428;Leicht bewölkt;8;5;0
28/11/2019;08:00;891;538;353;Stellenweiser leichter Regenfall;8;5;0
28/11/2019;09:00;778;506;272;Stellenweiser leichter Regenfall;8;5;0
28/11/2019;10:00;487;283;204;Stellenweiser leichter Regenfall;8;5;0
28/11/2019;11:00;684;329;355;Leichter Regenfall;8;6;0
28/11/2019;12:00;651;273;378;Leichter Regenfall;9;6;0
28/11/2019;13:00;921;384;537;Leichter Regenfall;8;5;0
28/11/2019;14:00;682;350;332;Leichter Regenfall;8;5;0
28/11/2019;15:00;981;481;500;Leichter Regenfall;8;4;0
28/11/2019;16:00;885;412;473;Leichter Regenfall;7;4;0
28/11/2019;17:00;1135;533;602;Leichter Regenfall;6;4;0
28/11/2019;18:00;933;489;444;Leichter Regenfall;5;4;0
28/11/2019;19:00;672;315;357;Leichter Regenfall;4;3;0
28/11/2019;20:00;490;228;262;Leichter Regenfall;3;2;0
28/11/2019;21:00;381;137;244;Leichter Regenfall;1;1;0
28/11/2019;22:00;292;114;178;Leichter Regenfall;2;2;0
28/11/2019;23:00;176;81;95;Leichter Regenfall;4;2;0
29/11/2019;00:00;83;25;58;Leichter Regenfall;5;3;0
29/11/2019;01:00;77;16;61;Leichter Regenfall;6;3;0
29/11/2019;02:00;70;5;65;Leichter Regenfall;6;4;0
29/11/2019;03:00;11;3;8;Leichter Regenfall;7;4;0
29/11/2019;04:00;19;4;15;Leichter Regenfall;7;4;0
29/11/2019;05:00;59;34;25;Mäßiger Regenfall;7;4;0
29/11/2019;06:00;149;91;58;Mäßiger Regenfall;7;4;1
29/11/2019;07:00;1030;673;357;Mäßiger Regenfall;7;4;0
29/11/2019;08:00;689;446;243;Mäßiger Regenfall;7;3;0
29/11/2019;09:00;660;391;269;Mäßiger Regenfall;6;3;1
29/11/2019;10:00;416;238;178;Mäßiger Regenfall;6;3;0
29/11/2019;11:00;569;306;263;Mäßiger Regenfall;6;3;1
29/11/2019;12:00;720;346;374;Mäßiger Regenfall;6;2;1
29/11/2019;13:00;934;363;571;Mäßiger Regenfall;6;2;0
29/11/2019;14:00;717;343;374;Mäßiger Regenfall;6;3;0
29/11/2019;15:00;739;351;388;Mäßiger Regenfall;6;3;0
29/11/2019;16:00;724;384;340;Mäßiger Regenfall;5;3;0
29/11/2019;17:00;743;352;391;Leichter Regenfall;5;3;0
29/11/2019;18:00;691;348;343;Leichter Regenfall;5;4;1
29/11/2019;19:00;515;223;292;Leichter Regenfall;4;3;0
29/11/2019;20:00;296;134;162;Mäßiger Regenfall;3;2;0
29/11/2019;21:00;238;106;132;Mäßiger Regenfall;2;2;0
29/11/2019;22:00;238;70;168;Mäßiger Regenfall;2;2;0
29/11/2019;23:00;179;50;129;Leichter Regenfall;2;2;0
30/11/2019;00:00;154;39;115;Leichter Regenfall;3;1;1
30/11/2019;01:00;107;30;77;Leichter Regenfall;3;2;0
30/11/2019;02:00;70;28;42;Mäßiger Regenfall;3;2;0
30/11/2019;03:00;39;10;29;Mäßiger Regenfall;3;3;0
30/11/2019;04:00;17;7;10;Mäßiger Regenfall;3;3;0
30/11/2019;05:00;24;17;7;Mäßiger Schneefall;3;2;0
30/11/2019;06:00;45;30;15;Mäßiger Schneefall;2;2;0
30/11/2019;07:00;92;52;40;Mäßiger Schneefall;2;2;0
30/11/2019;08:00;246;138;108;Leichter Nebel;3;2;0
30/11/2019;09:00;386;247;139;Leichter Nebel;3;2;0
30/11/2019;10:00;535;336;199;Leichter Nebel;4;3;0
30/11/2019;11:00;592;307;285;Leicht bewölkt;4;3;0
30/11/2019;12:00;665;353;312;Leicht bewölkt;5;4;0
30/11/2019;13:00;680;378;302;Leicht bewölkt;5;4;0
30/11/2019;14:00;681;333;348;Leicht bewölkt;5;3;0
30/11/2019;15:00;697;340;357;Leicht bewölkt;5;3;0
30/11/2019;16:00;696;331;365;Leicht bewölkt;4;2;0
30/11/2019;17:00;582;282;300;Leicht bewölkt;3;1;0
30/11/2019;18:00;492;251;241;Leicht bewölkt;2;-1;0
30/11/2019;19:00;471;238;233;Leicht bewölkt;1;-1;0
30/11/2019;20:00;314;152;162;Leicht bewölkt;1;-2;0
30/11/2019;21:00;289;124;165;Leicht bewölkt;0;-2;0
30/11/2019;22:00;232;73;159;Leicht bewölkt;0;-2;0
30/11/2019;23:00;176;61;115;Leicht bewölkt;0;-2;0
01/12/2019;00:00;153;49;104;Leicht bewölkt;0;-1;0
01/12/2019;01:00;133;42;91;Leicht bewölkt;0;-1;0
01/12/2019;02:00;87;22;65;Bedeckt;0;-1;0
01/12/2019;03:00;50;13;37;Bedeckt;0;0;0
01/12/2019;04:00;31;18;13;Bedeckt;0;0;0
01/12/2019;05:00;27;14;13;Bedeckt;0;0;0
01/12/2019;06:00;30;20;10;Bedeckt;1;0;0
01/12/2019;07:00;34;20;14;Bedeckt;1;0;0
01/12/2019;08:00;89;46;43;Bedeckt;2;0;0
01/12/2019;09:00;169;92;77;Bedeckt;2;0;0
01/12/2019;10:00;191;121;70;Bedeckt;3;1;0
01/12/2019;11:00;260;143;117;Bedeckt;3;1;0
01/12/2019;12:00;278;148;130;Bedeckt;4;1;0
01/12/2019;13:00;340;177;163;Bedeckt;4;2;0
01/12/2019;14:00;369;195;174;Leicht bewölkt;4;2;0
01/12/2019;15:00;395;230;165;Leicht bewölkt;4;2;0
01/12/2019;16:00;388;159;229;Leicht bewölkt;3;2;0
01/12/2019;17:00;458;226;232;Leicht bewölkt;3;2;0
01/12/2019;18:00;346;187;159;Leicht bewölkt;3;2;0
01/12/2019;19:00;291;150;141;Leicht bewölkt;2;1;0
01/12/2019;20:00;227;79;148;Bedeckt;1;1;0
01/12/2019;21:00;149;38;111;Bedeckt;0;0;0
01/12/2019;22:00;114;41;73;Bedeckt;0;0;0
01/12/2019;23:00;70;29;41;Leichter Eisregen;1;1;0
02/12/2019;00:00;31;10;21;Leichter Eisregen;2;2;0
02/12/2019;01:00;14;8;6;Leichter Eisregen;2;2;0
02/12/2019;02:00;6;1;5;Nieselregen;3;2;0
02/12/2019;03:00;3;2;1;Nieselregen;3;2;0
02/12/2019;04:00;7;6;1;Nieselregen;2;1;0
02/12/2019;05:00;44;30;14;Stellenweiser Eisregen;2;0;0
02/12/2019;06:00;198;128;70;Stellenweiser Eisregen;1;-1;0
02/12/2019;07:00;1070;674;396;Stellenweiser Eisregen;1;-1;0
02/12/2019;08:00;783;476;307;Starker Schneefall;1;-1;0
02/12/2019;09:00;777;499;278;Starker Schneefall;1;-1;0
02/12/2019;10:00;477;290;187;Starker Schneefall;2;-1;0
02/12/2019;11:00;620;319;301;Leichter Schneefall;2;0;0
02/12/2019;12:00;672;299;373;Leichter Schneefall;3;0;0
02/12/2019;13:00;931;412;519;Leichter Schneefall;3;0;0
02/12/2019;14:00;694;358;336;Stellenweise leichter Schneefall;2;0;0
02/12/2019;15:00;1014;489;525;Stellenweise leichter Schneefall;2;-1;0
02/12/2019;16:00;909;412;497;Stellenweise leichter Schneefall;1;-2;0
02/12/2019;17:00;1039;500;539;Leicht bewölkt;0;-3;0
02/12/2019;18:00;884;415;469;Leicht bewölkt;0;-4;0
02/12/2019;19:00;684;285;399;Leicht bewölkt;-1;-4;0
02/12/2019;20:00;474;202;272;Leichter Schneefall;-1;-4;0
02/12/2019;21:00;329;108;221;Leichter Schneefall;-1;-5;0
02/12/2019;22:00;254;105;149;Leichter Schneefall;-1;-5;0
02/12/2019;23:00;112;36;76;Bewölkt;-1;-4;0
03/12/2019;00:00;57;19;38;Bewölkt;-1;-4;0
03/12/2019;01:00;16;6;10;Bewölkt;-1;-4;0
03/12/2019;02:00;7;4;3;Sonnig;-1;-4;0
03/12/2019;03:00;8;4;4;Sonnig;-2;-4;0
03/12/2019;04:00;11;11;0;Sonnig;-1;-4;0
03/12/2019;05:00;50;38;12;Leicht bewölkt;-1;-4;0
03/12/2019;06:00;198;124;74;Leicht bewölkt;-1;-4;0
03/12/2019;07:00;1111;700;411;Leicht bewölkt;-1;-3;0
03/12/2019;08:00;824;489;335;Leicht bewölkt;0;-3;0
03/12/2019;09:00;874;577;297;Leicht bewölkt;1;-2;0
03/12/2019;10:00;538;301;237;Leicht bewölkt;2;-1;0
03/12/2019;11:00;662;335;327;Leicht bewölkt;3;0;0
03/12/2019;12:00;687;283;404;Leicht bewölkt;3;1;0
03/12/2019;13:00;980;449;531;Leicht bewölkt;3;0;0
03/12/2019;14:00;720;354;366;Leicht bewölkt;3;0;0
03/12/2019;15:00;1089;488;601;Leicht bewölkt;3;0;0
03/12/2019;16:00;989;519;470;Leicht bewölkt;2;-1;0
03/12/2019;17:00;1129;541;588;Sonnig;1;-3;0
03/12/2019;18:00;886;388;498;Sonnig;0;-4;0
03/12/2019;19:00;787;322;465;Sonnig;-1;-4;0
03/12/2019;20:00;428;180;248;Leicht bewölkt;-1;-4;0
03/12/2019;21:00;358;121;237;Leicht bewölkt;-1;-4;0
03/12/2019;22:00;312;89;223;Leicht bewölkt;-2;-4;0
03/12/2019;23:00;123;45;78;Leicht bewölkt;-2;-4;0
04/12/2019;00:00;39;10;29;Leicht bewölkt;-2;-4;0
04/12/2019;01:00;47;30;17;Leicht bewölkt;-2;-4;0
04/12/2019;02:00;13;6;7;Leicht bewölkt;-2;-4;0
04/12/2019;03:00;4;1;3;Leicht bewölkt;-2;-4;0
04/12/2019;04:00;4;3;1;Leicht bewölkt;-2;-4;0
04/12/2019;05:00;68;51;17;Leicht bewölkt;-2;-4;0
04/12/2019;06:00;192;124;68;Leicht bewölkt;-2;-4;0
04/12/2019;07:00;1045;688;357;Leicht bewölkt;-1;-2;0
04/12/2019;08:00;864;520;344;Leicht bewölkt;0;-1;0
04/12/2019;09:00;774;492;282;Leicht bewölkt;1;0;0
04/12/2019;10:00;505;322;183;Leicht bewölkt;2;2;0
04/12/2019;11:00;671;313;358;Sonnig;4;3;0
04/12/2019;12:00;635;278;357;Sonnig;5;5;0
04/12/2019;13:00;978;453;525;Sonnig;5;5;0
04/12/2019;14:00;621;296;325;Sonnig;4;4;0
04/12/2019;15:00;889;400;489;Sonnig;4;4;0
04/12/2019;16:00;881;454;427;Sonnig;3;3;0
04/12/2019;17:00;1059;531;528;Sonnig;3;3;0
04/12/2019;18:00;933;470;463;Sonnig;2;2;0
04/12/2019;19:00;688;293;395;Sonnig;2;1;0
04/12/2019;20:00;546;191;355;Sonnig;1;1;0
04/12/2019;21:00;375;118;257;Sonnig;1;1;0
04/12/2019;22:00;310;105;205;Sonnig;1;1;0
04/12/2019;23:00;168;65;103;Sonnig;1;1;0
05/12/2019;00:00;100;47;53;Sonnig;1;1;0
05/12/2019;01:00;43;11;32;Sonnig;0;0;0
05/12/2019;02:00;33;19;14;Sonnig;0;0;0
05/12/2019;03:00;11;7;4;Sonnig;-1;-1;0
05/12/2019;04:00;12;6;6;Sonnig;-1;-1;0
05/12/2019;05:00;51;41;10;Leicht bewölkt;-2;-2;0
05/12/2019;06:00;185;127;58;Leicht bewölkt;-2;-2;0
05/12/2019;07:00;1079;675;404;Leicht bewölkt;-1;-1;0
05/12/2019;08:00;873;556;317;Leicht bewölkt;0;0;0
05/12/2019;09:00;776;489;287;Leicht bewölkt;1;1;0
05/12/2019;10:00;486;289;197;Leicht bewölkt;3;3;0
05/12/2019;11:00;603;303;300;Leicht bewölkt;4;4;0
05/12/2019;12:00;613;271;342;Leicht bewölkt;6;6;0
05/12/2019;13:00;871;384;487;Leicht bewölkt;6;6;0
05/12/2019;14:00;671;309;362;Leicht bewölkt;5;5;0
05/12/2019;15:00;996;464;532;Leicht bewölkt;5;5;0
05/12/2019;16:00;919;467;452;Leicht bewölkt;4;4;0
05/12/2019;17:00;1114;564;550;Sonnig;3;3;0
05/12/2019;18:00;992;536;456;Sonnig;3;3;0
05/12/2019;19:00;666;320;346;Sonnig;2;2;0
05/12/2019;20:00;552;202;350;Sonnig;2;2;0
05/12/2019;21:00;403;149;254;Sonnig;1;1;0
05/12/2019;22:00;313;111;202;Sonnig;1;1;0
05/12/2019;23:00;198;56;142;Sonnig;1;1;0
06/12/2019;00:00;110;29;81;Sonnig;1;1;0
06/12/2019;01:00;60;11;49;Sonnig;1;0;0
06/12/2019;02:00;30;5;25;Sonnig;1;0;0
06/12/2019;03:00;14;4;10;Sonnig;0;0;0
06/12/2019;04:00;10;8;2;Sonnig;0;0;0
06/12/2019;05:00;55;40;15;Sonnig;0;-1;0
06/12/2019;06:00;174;112;62;Sonnig;0;-1;0
06/12/2019;07:00;983;630;353;Sonnig;1;0;0
06/12/2019;08:00;836;559;277;Sonnig;2;1;0
06/12/2019;09:00;706;452;254;Sonnig;3;2;0
06/12/2019;10:00;532;328;204;Sonnig;4;3;0
06/12/2019;11:00;657;338;319;Sonnig;6;5;0
06/12/2019;12:00;856;401;455;Sonnig;7;7;0
06/12/2019;13:00;1061;459;602;Sonnig;7;6;0
06/12/2019;14:00;866;466;400;Sonnig;7;6;0
06/12/2019;15:00;924;473;451;Sonnig;6;6;0
06/12/2019;16:00;891;370;521;Sonnig;5;4;0
06/12/2019;17:00;859;383;476;Sonnig;4;2;0
06/12/2019;18:00;750;418;332;Sonnig;3;1;0
06/12/2019;19:00;553;273;280;Sonnig;1;0;0
06/12/2019;20:00;390;166;224;Leicht bewölkt;0;-1;0
06/12/2019;21:00;325;94;231;Leicht bewölkt;-1;-2;0
06/12/2019;22:00;279;80;199;Leicht bewölkt;0;-1;0
06/12/2019;23:00;261;92;169;Leicht bewölkt;1;-1;0
07/12/2019;00:00;176;47;129;Leicht bewölkt;2;0;0
07/12/2019;01:00;118;37;81;Leicht bewölkt;3;0;0
07/12/2019;02:00;73;22;51;Bedeckt;3;1;0
07/12/2019;03:00;39;22;17;Bedeckt;4;1;0
07/12/2019;04:00;19;10;9;Bedeckt;4;1;0
07/12/2019;05:00;34;18;16;Nieselregen;4;1;0
07/12/2019;06:00;52;31;21;Nieselregen;5;1;0
07/12/2019;07:00;78;56;22;Nieselregen;5;2;0
07/12/2019;08:00;210;137;73;Leichter Regenfall;5;2;0
07/12/2019;09:00;359;239;120;Leichter Regenfall;5;2;0
07/12/2019;10:00;501;316;185;Leichter Regenfall;5;3;0
07/12/2019;11:00;502;275;227;Leichter Regenfall;6;3;0
07/12/2019;12:00;532;305;227;Leichter Regenfall;6;4;0
07/12/2019;13:00;572;322;250;Leichter Regenfall;6;4;0
07/12/2019;14:00;576;291;285;Leichter Regenfall;6;4;0
07/12/2019;15:00;615;319;296;Leichter Regenfall;6;4;0
07/12/2019;16:00;565;286;279;Leichter Regenfall;6;4;0
07/12/2019;17:00;575;269;306;Stellenweiser Regenfall;5;4;0
07/12/2019;18:00;555;248;307;Stellenweiser Regenfall;5;3;0
07/12/2019;19:00;521;314;207;Stellenweiser Regenfall;4;2;0
07/12/2019;20:00;336;179;157;Bewölkt;2;2;0
07/12/2019;21:00;306;120;186;Bewölkt;1;1;0
07/12/2019;22:00;282;65;217;Bewölkt;2;1;0
07/12/2019;23:00;226;68;158;Bedeckt;2;1;0
08/12/2019;00:00;173;58;115;Bedeckt;3;2;0
08/12/2019;01:00;164;50;114;Bedeckt;3;2;0
08/12/2019;02:00;78;31;47;Leicht bewölkt;3;2;0
08/12/2019;03:00;40;10;30;Leicht bewölkt;3;2;0
08/12/2019;04:00;27;14;13;Leicht bewölkt;3;1;0
08/12/2019;05:00;19;7;12;Leicht bewölkt;3;1;0
08/12/2019;06:00;38;28;10;Leicht bewölkt;3;0;0
08/12/2019;07:00;49;24;25;Leicht bewölkt;3;1;0
08/12/2019;08:00;106;48;58;Leicht bewölkt;4;1;0
08/12/2019;09:00;161;89;72;Leicht bewölkt;5;2;0
08/12/2019;10:00;230;139;91;Leicht bewölkt;6;3;0
08/12/2019;11:00;313;167;146;Leicht bewölkt;7;4;0
08/12/2019;12:00;352;196;156;Leicht bewölkt;8;6;0
08/12/2019;13:00;386;204;182;Leicht bewölkt;8;6;0
08/12/2019;14:00;437;227;210;Leicht bewölkt;8;6;0
08/12/2019;15:00;453;255;198;Leicht bewölkt;8;6;0
08/12/2019;16:00;407;212;195;Leicht bewölkt;7;5;0
08/12/2019;17:00;432;224;208;Leicht bewölkt;7;5;0
08/12/2019;18:00;370;150;220;Leicht bewölkt;6;4;0
08/12/2019;19:00;268;112;156;Leicht bewölkt;5;4;0
08/12/2019;20:00;229;67;162;Leicht bewölkt;4;3;0
08/12/2019;21:00;163;58;105;Leicht bewölkt;3;2;0
08/12/2019;22:00;114;45;69;Leicht bewölkt;4;3;0
08/12/2019;23:00;64;23;41;Leichter Regenfall;4;3;0
09/12/2019;00:00;25;12;13;Leichter Regenfall;5;3;0
09/12/2019;01:00;14;5;9;Leichter Regenfall;5;3;0
09/12/2019;02:00;5;1;4;Stellenweiser Nieselregen;6;3;0
09/12/2019;03:00;5;2;3;Stellenweiser Nieselregen;6;3;0
09/12/2019;04:00;7;4;3;Stellenweiser Nieselregen;6;2;0
09/12/2019;05:00;48;30;18;Leichter Regenschauer;5;1;0
09/12/2019;06:00;177;116;61;Leichter Regenschauer;5;0;0
09/12/2019;07:00;1060;650;410;Leichter Regenschauer;5;1;0
09/12/2019;08:00;791;482;309;Leichter Regenfall;5;1;0
09/12/2019;09:00;755;487;268;Leichter Regenfall;6;2;0
09/12/2019;10:00;464;269;195;Leichter Regenfall;6;2;0
09/12/2019;11:00;650;302;348;Stellenweiser Regenfall;7;3;0
09/12/2019;12:00;689;313;376;Stellenweiser Regenfall;8;4;0
09/12/2019;13:00;802;333;469;Stellenweiser Regenfall;7;3;0
09/12/2019;14:00;532;253;279;Bewölkt;7;3;0
09/12/2019;15:00;812;392;420;Bewölkt;6;2;0
09/12/2019;16:00;737;346;391;Bewölkt;5;1;0
09/12/2019;17:00;886;433;453;Leichter Regenfall;5;0;0
09/12/2019;18:00;737;357;380;Leichter Regenfall;4;0;0
09/12/2019;19:00;552;215;337;Leichter Regenfall;4;0;0
09/12/2019;20:00;391;133;258;Leichter Regenfall;4;0;0
09/12/2019;21:00;236;80;156;Leichter Regenfall;4;0;0
09/12/2019;22:00;211;76;135;Leichter Regenfall;4;0;0
09/12/2019;23:00;128;62;66;Leichter Eisregen;4;0;0
10/12/2019;00:00;39;13;26;Leichter Eisregen;4;0;0
10/12/2019;01:00;27;15;12;Leichter Eisregen;3;0;0
10/12/2019;02:00;11;3;8;Mäßiger bis starker Eisregen;3;0;0
10/12/2019;03:00;5;3;2;Mäßiger bis starker Eisregen;3;0;0
10/12/2019;04:00;7;6;1;Mäßiger bis starker Eisregen;3;-1;0
10/12/2019;05:00;47;36;11;Starker Schneefall;2;-1;0
10/12/2019;06:00;203;147;56;Starker Schneefall;2;-2;0
10/12/2019;07:00;1121;723;398;Starker Schneefall;2;-1;0
10/12/2019;08:00;866;539;327;Stellenweise starker Schneefall;2;0;0
10/12/2019;09:00;824;525;299;Stellenweise starker Schneefall;2;1;0
10/12/2019;10:00;506;303;203;Stellenweise starker Schneefall;3;1;0
10/12/2019;11:00;700;379;321;Mäßige bis starke Schneefälle;3;2;0
10/12/2019;12:00;724;302;422;Mäßige bis starke Schneefälle;4;3;0
10/12/2019;13:00;1007;433;574;Mäßige bis starke Schneefälle;4;3;0
10/12/2019;14:00;749;367;382;Stellenweiser Eisregen;3;3;0
10/12/2019;15:00;1043;457;586;Stellenweiser Eisregen;3;3;0
10/12/2019;16:00;989;493;496;Stellenweiser Eisregen;2;1;0
10/12/2019;17:00;1119;541;578;Leicht bewölkt;1;0;0
10/12/2019;18:00;931;464;467;Leicht bewölkt;0;-1;0
10/12/2019;19:00;775;333;442;Leicht bewölkt;-1;-2;0
10/12/2019;20:00;473;167;306;Leicht bewölkt;-2;-2;0
10/12/2019;21:00;341;108;233;Leicht bewölkt;-2;-3;0
10/12/2019;22:00;299;72;227;Leicht bewölkt;-2;-3;0
10/12/2019;23:00;141;47;94;Leicht bewölkt;-2;-2;0
11/12/2019;00:00;65;23;42;Leicht bewölkt;-2;-2;0
11/12/2019;01:00;38;18;20;Leicht bewölkt;-1;-2;0
11/12/2019;02:00;11;3;8;Leicht bewölkt;-1;-1;0
11/12/2019;03:00;4;3;1;Leicht bewölkt;-1;-1;0
11/12/2019;04:00;5;4;1;Leicht bewölkt;-1;-1;0
11/12/2019;05:00;60;44;16;Leicht bewölkt;-1;-1;0
11/12/2019;06:00;184;128;56;Leicht bewölkt;-1;-1;0
11/12/2019;07:00;1133;738;395;Leicht bewölkt;0;0;0
11/12/2019;08:00;794;464;330;Leicht bewölkt;0;0;0
11/12/2019;09:00;745;481;264;Leicht bewölkt;1;1;0
11/12/2019;10:00;424;265;159;Leicht bewölkt;2;2;0
11/12/2019;11:00;666;321;345;Bedeckt;3;3;0
11/12/2019;12:00;734;318;416;Bedeckt;3;3;0
11/12/2019;13:00;955;451;504;Bedeckt;3;3;0
11/12/2019;14:00;697;344;353;Bedeckt;3;3;0
11/12/2019;15:00;904;392;512;Bedeckt;4;4;0
11/12/2019;16:00;870;435;435;Bedeckt;3;3;0
11/12/2019;17:00;1109;511;598;Bedeckt;3;2;0
11/12/2019;18:00;831;355;476;Bedeckt;3;1;0
11/12/2019;19:00;680;295;385;Bedeckt;3;1;0
11/12/2019;20:00;456;178;278;Bedeckt;3;0;0
11/12/2019;21:00;346;141;205;Bedeckt;3;-1;0
11/12/2019;22:00;264;116;148;Bedeckt;3;-1;0
11/12/2019;23:00;179;59;120;Starker Schneefall;3;0;0
12/12/2019;00:00;90;36;54;Starker Schneefall;3;0;0
12/12/2019;01:00;60;20;40;Starker Schneefall;3;0;0
12/12/2019;02:00;19;10;9;Starker Schneefall;3;1;0
12/12/2019;03:00;5;3;2;Starker Schneefall;3;1;0
12/12/2019;04:00;10;5;5;Starker Schneefall;2;1;0
12/12/2019;05:00;52;39;13;Mäßige bis starke Schneefälle;2;0;0
12/12/2019;06:00;160;101;59;Mäßige bis starke Schneefälle;2;0;0
12/12/2019;07:00;1036;672;364;Mäßige bis starke Schneefälle;2;-1;0
12/12/2019;08:00;707;454;253;Starker Schneefall;2;-1;0
12/12/2019;09:00;690;442;248;Starker Schneefall;2;-2;0
12/12/2019;10:00;405;254;151;Starker Schneefall;2;-1;0
12/12/2019;11:00;578;290;288;Starker Schneefall;3;-1;0
12/12/2019;12:00;592;288;304;Starker Schneefall;3;-1;0
12/12/2019;13:00;885;378;507;Starker Schneefall;3;-1;0
12/12/2019;14:00;672;319;353;Starker Schneefall;3;0;0
12/12/2019;15:00;1016;496;520;Starker Schneefall;3;0;0
12/12/2019;16:00;898;435;463;Starker Schneefall;2;0;0
12/12/2019;17:00;1041;486;555;Stellenweise leichter Schneefall;1;-1;0
12/12/2019;18:00;881;396;485;Stellenweise leichter Schneefall;1;-1;0
12/12/2019;19:00;690;310;380;Stellenweise leichter Schneefall;0;-2;0
12/12/2019;20:00;483;200;283;Leicht bewölkt;-1;-3;0
12/12/2019;21:00;328;131;197;Leicht bewölkt;-1;-4;0
12/12/2019;22:00;340;121;219;Leicht bewölkt;-1;-4;0
12/12/2019;23:00;162;56;106;Leicht bewölkt;-1;-4;0
13/12/2019;00:00;108;39;69;Leicht bewölkt;-2;-4;0
13/12/2019;01:00;54;12;42;Leicht bewölkt;-1;-3;0
13/12/2019;02:00;31;12;19;Leicht bewölkt;-1;-3;0
13/12/2019;03:00;12;4;8;Leicht bewölkt;-1;-2;0
13/12/2019;04:00;21;13;8;Leicht bewölkt;0;-2;0
13/12/2019;05:00;51;35;16;Stellenweise leichter Schneefall;0;-1;0
13/12/2019;06:00;194;135;59;Stellenweise leichter Schneefall;0;-1;0
13/12/2019;07:00;894;580;314;Stellenweise leichter Schneefall;0;-1;0
13/12/2019;08:00;678;425;253;Starker Schneefall;1;-2;0
13/12/2019;09:00;481;306;175;Starker Schneefall;1;-2;0
13/12/2019;10:00;344;199;145;Starker Schneefall;1;-2;0
13/12/2019;11:00;418;210;208;Starker Schneefall;2;-2;0
13/12/2019;12:00;622;293;329;Starker Schneefall;2;-2;0
13/12/2019;13:00;769;308;461;Starker Schneefall;2;-2;0
13/12/2019;14:00;588;288;300;Starker Schneefall;3;-2;0
13/12/2019;15:00;541;264;277;Starker Schneefall;3;-2;0
13/12/2019;16:00;582;285;297;Starker Schneefall;3;-2;0
13/12/2019;17:00;598;313;285;Leichter Eisregen;2;-1;0
13/12/2019;18:00;531;263;268;Leichter Eisregen;2;0;0
13/12/2019;19:00;453;211;242;Leichter Eisregen;1;-1;0
13/12/2019;20:00;258;127;131;Leichter Eisregen;-1;-1;0
13/12/2019;21:00;232;95;137;Leichter Eisregen;-2;-2;0
13/12/2019;22:00;220;75;145;Leichter Eisregen;-1;-2;0
13/12/2019;23:00;177;59;118;Mäßiger Schneefall;0;-2;0
14/12/2019;00:00;148;44;104;Mäßiger Schneefall;0;-3;0
14/12/2019;01:00;90;24;66;Mäßiger Schneefall;1;-3;0
14/12/2019;02:00;93;24;69;Bewölkt;1;-3;0
14/12/2019;03:00;52;19;33;Bewölkt;1;-3;0
14/12/2019;04:00;25;7;18;Bewölkt;1;-3;0
14/12/2019;05:00;35;24;11;Stellenweise mäßiger Schneefall;2;-3;0
14/12/2019;06:00;50;33;17;Stellenweise mäßiger Schneefall;2;-2;0
14/12/2019;07:00;66;46;20;Stellenweise mäßiger Schneefall;3;-1;0
14/12/2019;08:00;159;109;50;Leichter Eisregen;4;0;0
14/12/2019;09:00;276;183;93;Leichter Eisregen;5;1;0
14/12/2019;10:00;452;289;163;Leichter Eisregen;5;1;0
14/12/2019;11:00;490;287;203;Leichter Regenfall;6;2;0
14/12/2019;12:00;600;321;279;Leichter Regenfall;7;3;0
14/12/2019;13:00;512;256;256;Leichter Regenfall;6;3;0
14/12/2019;14:00;534;291;243;Leicht bewölkt;6;3;0
14/12/2019;15:00;619;321;298;Leicht bewölkt;6;2;0
14/12/2019;16:00;550;283;267;Leicht bewölkt;6;2;0
14/12/2019;17:00;567;270;297;Leichter Regenschauer;5;2;0
14/12/2019;18:00;566;275;291;Leichter Regenschauer;5;2;0
14/12/2019;19:00;388;189;199;Leichter Regenschauer;5;2;0
14/12/2019;20:00;301;170;131;Stellenweiser Regenfall;5;2;0
14/12/2019;21:00;271;112;159;Stellenweiser Regenfall;4;2;0
14/12/2019;22:00;221;71;150;Stellenweiser Regenfall;4;2;0
14/12/2019;23:00;166;47;119;Leicht bewölkt;4;2;0
15/12/2019;00:00;174;52;122;Leicht bewölkt;4;2;0
15/12/2019;01:00;129;37;92;Leicht bewölkt;4;2;0
15/12/2019;02:00;94;26;68;Stellenweiser Nieselregen;4;2;0
15/12/2019;03:00;45;15;30;Stellenweiser Nieselregen;4;2;0
15/12/2019;04:00;22;11;11;Stellenweiser Nieselregen;4;1;0
15/12/2019;05:00;22;12;10;Leicht bewölkt;4;1;0
15/12/2019;06:00;30;17;13;Leicht bewölkt;4;1;0
15/12/2019;07:00;45;30;15;Leicht bewölkt;4;2;0
15/12/2019;08:00;82;39;43;Leicht bewölkt;5;2;0
15/12/2019;09:00;212;111;101;Leicht bewölkt;5;3;0
15/12/2019;10:00;212;144;68;Leicht bewölkt;6;4;0
15/12/2019;11:00;240;122;118;Leicht bewölkt;7;5;0
15/12/2019;12:00;370;199;171;Leicht bewölkt;8;7;0
15/12/2019;13:00;343;200;143;Leicht bewölkt;8;7;0
15/12/2019;14:00;453;232;221;Leicht bewölkt;8;7;0
15/12/2019;15:00;465;268;197;Leicht bewölkt;8;7;0
15/12/2019;16:00;440;235;205;Leicht bewölkt;8;6;0
15/12/2019;17:00;370;173;197;Leicht bewölkt;7;5;0
15/12/2019;18:00;390;178;212;Leicht bewölkt;6;5;0
15/12/2019;19:00;313;136;177;Leicht bewölkt;6;4;0
15/12/2019;20:00;235;84;151;Leicht bewölkt;5;4;0
15/12/2019;21:00;149;47;102;Leicht bewölkt;5;3;0
15/12/2019;22:00;145;54;91;Leicht bewölkt;4;2;0
15/12/2019;23:00;71;29;42;Leicht bewölkt;4;2;0
16/12/2019;00:00;36;14;22;Leicht bewölkt;4;1;0
16/12/2019;01:00;17;11;6;Leicht bewölkt;3;1;0
16/12/2019;02:00;11;4;7;Leicht bewölkt;3;1;0
16/12/2019;03:00;2;2;0;Leicht bewölkt;2;0;0
16/12/2019;04:00;8;6;2;Leicht bewölkt;3;1;0
16/12/2019;05:00;47;33;14;Leicht bewölkt;3;2;0
16/12/2019;06:00;195;134;61;Leicht bewölkt;4;4;0
16/12/2019;07:00;1006;632;374;Leicht bewölkt;4;4;0
16/12/2019;08:00;793;478;315;Leicht bewölkt;4;4;0
16/12/2019;09:00;823;534;289;Leicht bewölkt;5;5;0
16/12/2019;10:00;555;327;228;Leicht bewölkt;6;6;0
16/12/2019;11:00;678;346;332;Leicht bewölkt;7;7;0
16/12/2019;12:00;707;302;405;Leicht bewölkt;9;9;0
16/12/2019;13:00;891;382;509;Leicht bewölkt;9;9;0
16/12/2019;14:00;672;357;315;Leicht bewölkt;9;9;0
16/12/2019;15:00;1055;522;533;Leicht bewölkt;9;9;0
16/12/2019;16:00;1026;509;517;Leicht bewölkt;8;8;0
16/12/2019;17:00;1134;498;636;Leicht bewölkt;7;7;0
16/12/2019;18:00;864;384;480;Leicht bewölkt;6;6;0
16/12/2019;19:00;721;321;400;Leicht bewölkt;6;6;0
16/12/2019;20:00;477;171;306;Leicht bewölkt;5;5;0
16/12/2019;21:00;358;124;234;Leicht bewölkt;5;5;0
16/12/2019;22:00;291;108;183;Leicht bewölkt;5;5;0
16/12/2019;23:00;173;58;115;Leicht bewölkt;5;5;0
17/12/2019;00:00;78;25;53;Leicht bewölkt;5;5;0
17/12/2019;01:00;52;7;45;Leicht bewölkt;5;5;0
17/12/2019;02:00;14;5;9;Leicht bewölkt;5;5;0
17/12/2019;03:00;15;11;4;Leicht bewölkt;6;5;0
17/12/2019;04:00;13;7;6;Leicht bewölkt;6;5;0
17/12/2019;05:00;49;34;15;Leicht bewölkt;6;5;0
17/12/2019;06:00;177;114;63;Leicht bewölkt;6;5;0
17/12/2019;07:00;1094;703;391;Leicht bewölkt;6;6;0
17/12/2019;08:00;878;534;344;Leicht bewölkt;7;6;0
17/12/2019;09:00;915;578;337;Leicht bewölkt;7;7;0
17/12/2019;10:00;574;369;205;Leicht bewölkt;8;8;0
17/12/2019;11:00;697;325;372;Leicht bewölkt;9;9;0
17/12/2019;12:00;795;319;476;Leicht bewölkt;11;11;0
17/12/2019;13:00;960;461;499;Leicht bewölkt;10;10;0
17/12/2019;14:00;760;382;378;Leicht bewölkt;10;10;0
17/12/2019;15:00;1054;491;563;Leicht bewölkt;10;10;0
17/12/2019;16:00;1021;512;509;Leicht bewölkt;9;9;0
17/12/2019;17:00;1141;570;571;Leicht bewölkt;8;8;0
17/12/2019;18:00;963;483;480;Leicht bewölkt;7;7;0
17/12/2019;19:00;774;326;448;Leicht bewölkt;7;7;0
17/12/2019;20:00;456;181;275;Leicht bewölkt;6;6;0
17/12/2019;21:00;387;96;291;Leicht bewölkt;6;5;0
17/12/2019;22:00;327;99;228;Leicht bewölkt;6;5;0
17/12/2019;23:00;176;52;124;Leicht bewölkt;6;5;0
18/12/2019;00:00;116;38;78;Leicht bewölkt;5;5;0
18/12/2019;01:00;63;25;38;Leicht bewölkt;5;5;0
18/12/2019;02:00;27;17;10;Leicht bewölkt;5;5;0
18/12/2019;03:00;8;3;5;Leicht bewölkt;6;6;0
18/12/2019;04:00;10;7;3;Leicht bewölkt;6;6;0
18/12/2019;05:00;62;47;15;Leicht bewölkt;6;6;0
18/12/2019;06:00;189;123;66;Leicht bewölkt;6;6;0
18/12/2019;07:00;1113;719;394;Leicht bewölkt;7;7;0
18/12/2019;08:00;857;500;357;Stellenweiser Regenfall;7;7;0
18/12/2019;09:00;833;561;272;Stellenweiser Regenfall;8;8;0
18/12/2019;10:00;518;317;201;Stellenweiser Regenfall;9;9;0
18/12/2019;11:00;634;321;313;Leicht bewölkt;10;10;0
18/12/2019;12:00;738;363;375;Leicht bewölkt;11;11;0
18/12/2019;13:00;1046;489;557;Leicht bewölkt;11;11;0
18/12/2019;14:00;732;398;334;Leicht bewölkt;10;11;0
18/12/2019;15:00;975;461;514;Leicht bewölkt;10;10;0
18/12/2019;16:00;997;492;505;Leicht bewölkt;9;9;0
18/12/2019;17:00;1061;517;544;Leicht bewölkt;9;8;0
18/12/2019;18:00;950;467;483;Leicht bewölkt;8;8;0
18/12/2019;19:00;705;336;369;Leicht bewölkt;7;7;0
18/12/2019;20:00;488;173;315;Leicht bewölkt;7;7;0
18/12/2019;21:00;350;105;245;Leicht bewölkt;7;6;0
18/12/2019;22:00;308;93;215;Leicht bewölkt;6;6;0
18/12/2019;23:00;189;63;126;Leicht bewölkt;6;6;0
19/12/2019;00:00;122;34;88;Leicht bewölkt;6;6;0
19/12/2019;01:00;76;22;54;Leicht bewölkt;6;6;0
19/12/2019;02:00;33;23;10;Leicht bewölkt;5;5;0
19/12/2019;03:00;11;4;7;Leicht bewölkt;5;5;0
19/12/2019;04:00;11;8;3;Leicht bewölkt;5;5;0
19/12/2019;05:00;54;37;17;Leicht bewölkt;4;4;0
19/12/2019;06:00;163;106;57;Leicht bewölkt;4;4;0
19/12/2019;07:00;994;643;351;Leicht bewölkt;5;5;0
19/12/2019;08:00;728;437;291;Bedeckt;6;6;0
19/12/2019;09:00;695;446;249;Bedeckt;6;6;0
19/12/2019;10:00;456;280;176;Bedeckt;7;7;0
19/12/2019;11:00;631;317;314;Leicht bewölkt;8;8;0
19/12/2019;12:00;701;344;357;Leicht bewölkt;9;9;0
19/12/2019;13:00;919;382;537;Leicht bewölkt;9;9;0
19/12/2019;14:00;692;347;345;Bewölkt;9;9;0
19/12/2019;15:00;1045;500;545;Bewölkt;9;9;0
19/12/2019;16:00;918;465;453;Bewölkt;8;8;0
19/12/2019;17:00;1009;464;545;Leicht bewölkt;7;7;0
19/12/2019;18:00;864;456;408;Leicht bewölkt;6;6;0
19/12/2019;19:00;629;284;345;Leicht bewölkt;5;5;0
19/12/2019;20:00;382;134;248;Leicht bewölkt;5;4;0
19/12/2019;21:00;338;110;228;Leicht bewölkt;4;3;0
19/12/2019;22:00;248;89;159;Leicht bewölkt;4;3;0
19/12/2019;23:00;230;79;151;Leicht bewölkt;4;3;0
20/12/2019;00:00;143;60;83;Leicht bewölkt;4;3;0
20/12/2019;01:00;106;16;90;Leicht bewölkt;4;3;0
20/12/2019;02:00;27;16;11;Leicht bewölkt;4;3;0
20/12/2019;03:00;21;10;11;Leicht bewölkt;5;3;0
20/12/2019;04:00;7;4;3;Leicht bewölkt;5;4;0
20/12/2019;05:00;37;29;8;Leicht bewölkt;5;4;0
20/12/2019;06:00;147;82;65;Leicht bewölkt;5;4;0
20/12/2019;07:00;587;306;281;Leicht bewölkt;5;4;0
20/12/2019;08:00;613;384;229;Bedeckt;5;4;0
20/12/2019;09:00;852;610;242;Bedeckt;6;5;0
20/12/2019;10:00;559;308;251;Bedeckt;7;6;0
20/12/2019;11:00;639;344;295;Leicht bewölkt;8;8;0
20/12/2019;12:00;827;380;447;Leicht bewölkt;9;9;0
20/12/2019;13:00;782;301;481;Leicht bewölkt;9;9;0
20/12/2019;14:00;721;367;354;Bewölkt;9;9;0
20/12/2019;15:00;693;360;333;Bewölkt;9;9;0
20/12/2019;16:00;681;339;342;Bewölkt;8;7;0
20/12/2019;17:00;604;290;314;Bewölkt;7;5;0
20/12/2019;18:00;598;296;302;Bewölkt;6;3;0
20/12/2019;19:00;391;177;214;Bewölkt;5;3;0
20/12/2019;20:00;311;122;189;Leichter Regenfall;4;2;0
20/12/2019;21:00;178;68;110;Leichter Regenfall;3;2;0
20/12/2019;22:00;237;87;150;Leichter Regenfall;4;3;0
20/12/2019;23:00;167;33;134;Leichter Regenfall;4;3;0
21/12/2019;00:00;110;28;82;Leichter Regenfall;5;4;1
21/12/2019;01:00;83;25;58;Leichter Regenfall;5;4;0
21/12/2019;02:00;66;23;43;Mäßiger Regenfall;5;4;0
21/12/2019;03:00;47;20;27;Mäßiger Regenfall;6;4;0
21/12/2019;04:00;23;12;11;Mäßiger Regenfall;5;3;0
21/12/2019;05:00;25;18;7;Stellenweiser Nieselregen;5;3;0
21/12/2019;06:00;29;17;12;Stellenweiser Nieselregen;5;3;0
21/12/2019;07:00;49;24;25;Stellenweiser Nieselregen;5;3;0
21/12/2019;08:00;106;63;43;Nieselregen;5;4;0
21/12/2019;09:00;281;181;100;Nieselregen;5;4;0
21/12/2019;10:00;345;208;137;Nieselregen;6;4;0
21/12/2019;11:00;474;263;211;Nieselregen;6;4;0
21/12/2019;12:00;474;264;210;Nieselregen;6;4;0
21/12/2019;13:00;486;261;225;Nieselregen;6;5;0
21/12/2019;14:00;462;235;227;Leichter Regenfall;7;5;0
21/12/2019;15:00;422;218;204;Leichter Regenfall;7;5;0
21/12/2019;16:00;454;207;247;Leichter Regenfall;6;4;0
21/12/2019;17:00;432;212;220;Leicht bewölkt;5;4;0
21/12/2019;18:00;390;190;200;Leicht bewölkt;5;3;0
21/12/2019;19:00;356;206;150;Leicht bewölkt;4;2;0
21/12/2019;20:00;194;101;93;Leicht bewölkt;3;2;0
21/12/2019;21:00;192;71;121;Leicht bewölkt;3;1;0
21/12/2019;22:00;162;35;127;Leicht bewölkt;2;1;0
21/12/2019;23:00;121;37;84;Bedeckt;2;1;0
22/12/2019;00:00;107;22;85;Bedeckt;2;1;0
22/12/2019;01:00;58;16;42;Bedeckt;3;1;0
22/12/2019;02:00;49;9;40;Stellenweiser leichter Regenfall;3;1;0
22/12/2019;03:00;45;10;35;Stellenweiser leichter Regenfall;3;1;0
22/12/2019;04:00;12;2;10;Stellenweiser leichter Regenfall;3;1;0
22/12/2019;05:00;20;7;13;Stellenweiser Nieselregen;4;1;0
22/12/2019;06:00;28;18;10;Stellenweiser Nieselregen;4;2;0
22/12/2019;07:00;22;14;8;Stellenweiser Nieselregen;4;2;0
22/12/2019;08:00;36;16;20;Stellenweiser Nieselregen;5;3;0
22/12/2019;09:00;79;44;35;Stellenweiser Nieselregen;5;4;0
22/12/2019;10:00;104;61;43;Stellenweiser Nieselregen;6;4;0
22/12/2019;11:00;133;67;66;Leicht bewölkt;6;5;0
22/12/2019;12:00;151;79;72;Leicht bewölkt;7;5;0
22/12/2019;13:00;115;52;63;Leicht bewölkt;7;4;0
22/12/2019;14:00;108;59;49;Nieselregen;7;3;0
22/12/2019;15:00;151;87;64;Nieselregen;6;2;0
22/12/2019;16:00;159;100;59;Nieselregen;6;2;0
22/12/2019;17:00;150;72;78;Mäßiger Regenfall;6;2;0
22/12/2019;18:00;153;81;72;Mäßiger Regenfall;6;1;0
22/12/2019;19:00;147;94;53;Mäßiger Regenfall;5;1;0
22/12/2019;20:00;132;61;71;Mäßiger Regenfall;5;1;0
22/12/2019;21:00;98;42;56;Mäßiger Regenfall;5;0;0
22/12/2019;22:00;91;33;58;Mäßiger Regenfall;5;0;0
22/12/2019;23:00;54;10;44;Nieselregen;5;0;0
23/12/2019;00:00;46;12;34;Nieselregen;5;0;0
23/12/2019;01:00;49;10;39;Nieselregen;5;1;0
23/12/2019;02:00;14;10;4;Leichter Regenfall;5;1;0
23/12/2019;03:00;12;2;10;Leichter Regenfall;5;1;0
23/12/2019;04:00;11;3;8;Leichter Regenfall;5;1;0
23/12/2019;05:00;30;21;9;Leichter Regenfall;5;1;0
23/12/2019;06:00;72;55;17;Leichter Regenfall;5;1;0
23/12/2019;07:00;132;81;51;Leichter Regenfall;5;1;0
23/12/2019;08:00;180;125;55;Leichter Regenfall;5;1;0
23/12/2019;09:00;305;212;93;Leichter Regenfall;5;1;0
23/12/2019;10:00;359;201;158;Leichter Regenfall;5;1;0
23/12/2019;11:00;350;168;182;Stellenweiser Nieselregen;5;1;0
23/12/2019;12:00;373;170;203;Stellenweiser Nieselregen;5;1;0
23/12/2019;13:00;396;194;202;Stellenweiser Nieselregen;5;1;0
23/12/2019;14:00;347;175;172;Nieselregen;5;1;0
23/12/2019;15:00;458;223;235;Nieselregen;5;1;0
23/12/2019;16:00;398;182;216;Nieselregen;4;1;0
23/12/2019;17:00;371;154;217;Leichter Regenfall;3;1;0
23/12/2019;18:00;267;100;167;Leichter Regenfall;3;2;0
23/12/2019;19:00;225;89;136;Leichter Regenfall;1;1;0
23/12/2019;20:00;133;63;70;Leichter Regenfall;0;0;0
23/12/2019;21:00;78;32;46;Leichter Regenfall;-1;-1;0
23/12/2019;22:00;79;38;41;Leichter Regenfall;0;-1;0
23/12/2019;23:00;41;11;30;Leichter Regenfall;1;0;0
24/12/2019;00:00;52;20;32;Leichter Regenfall;2;0;0
24/12/2019;01:00;33;11;22;Leichter Regenfall;3;0;0
24/12/2019;02:00;9;2;7;Stellenweiser Regenfall;3;1;0
24/12/2019;03:00;18;7;11;Stellenweiser Regenfall;4;1;0
24/12/2019;04:00;6;4;2;Stellenweiser Regenfall;4;1;0
24/12/2019;05:00;24;16;8;Stellenweiser Regenfall;3;1;0
24/12/2019;06:00;27;19;8;Stellenweiser Regenfall;3;1;0
24/12/2019;07:00;62;49;13;Stellenweiser Regenfall;4;1;0
24/12/2019;08:00;147;91;56;Bedeckt;4;2;0
24/12/2019;09:00;273;175;98;Bedeckt;4;2;0
24/12/2019;10:00;307;177;130;Bedeckt;4;2;0
24/12/2019;11:00;269;115;154;Stellenweiser Regenfall;5;2;0
24/12/2019;12:00;213;79;134;Stellenweiser Regenfall;5;2;0
24/12/2019;13:00;182;78;104;Stellenweiser Regenfall;5;3;0
24/12/2019;14:00;134;47;87;Leichter Regenfall;6;3;0
24/12/2019;15:00;106;49;57;Leichter Regenfall;6;4;0
24/12/2019;16:00;117;41;76;Leichter Regenfall;5;3;0
24/12/2019;17:00;69;40;29;Leichter Regenfall;5;3;0
24/12/2019;18:00;64;24;40;Leichter Regenfall;4;3;0
24/12/2019;19:00;56;27;29;Leichter Regenfall;3;2;0
24/12/2019;20:00;36;19;17;Leicht bewölkt;1;1;0
24/12/2019;21:00;30;19;11;Leicht bewölkt;0;0;0
24/12/2019;22:00;40;21;19;Leicht bewölkt;1;0;0
24/12/2019;23:00;45;29;16;Stellenweiser Regenfall;2;1;0
25/12/2019;00:00;51;22;29;Stellenweiser Regenfall;4;1;0
25/12/2019;01:00;12;4;8;Stellenweiser Regenfall;5;2;0
25/12/2019;02:00;29;7;22;Bedeckt;6;2;0
25/12/2019;03:00;5;0;5;Bedeckt;7;3;0
25/12/2019;04:00;7;2;5;Bedeckt;7;3;0
25/12/2019;05:00;14;8;6;Leichter Regenfall;7;3;0
25/12/2019;06:00;16;10;6;Leichter Regenfall;7;3;0
25/12/2019;07:00;12;8;4;Leichter Regenfall;7;3;0
25/12/2019;08:00;16;5;11;Bedeckt;7;3;0
25/12/2019;09:00;45;26;19;Bedeckt;7;3;0
25/12/2019;10:00;33;18;15;Bedeckt;7;3;0
25/12/2019;11:00;116;52;64;Leichter Regenfall;7;3;0
25/12/2019;12:00;97;55;42;Leichter Regenfall;7;3;0
25/12/2019;13:00;98;49;49;Leichter Regenfall;7;3;0
25/12/2019;14:00;78;29;49;Bedeckt;7;3;0
25/12/2019;15:00;62;29;33;Bedeckt;7;3;0
25/12/2019;16:00;71;36;35;Bedeckt;6;3;0
25/12/2019;17:00;90;42;48;Stellenweiser Regenfall;5;3;0
25/12/2019;18:00;66;27;39;Stellenweiser Regenfall;5;3;0
25/12/2019;19:00;55;32;23;Stellenweiser Regenfall;4;3;0
25/12/2019;20:00;34;14;20;Stellenweiser Regenfall;4;3;0
25/12/2019;21:00;52;30;22;Stellenweiser Regenfall;3;3;0
25/12/2019;22:00;38;17;21;Stellenweiser Regenfall;3;3;0
25/12/2019;23:00;26;11;15;Stellenweiser Regenfall;2;2;0
26/12/2019;00:00;34;21;13;Stellenweiser Regenfall;2;2;0
26/12/2019;01:00;25;8;17;Stellenweiser Regenfall;2;1;0
26/12/2019;02:00;13;2;11;Leicht bewölkt;1;1;0
26/12/2019;03:00;5;2;3;Leicht bewölkt;1;0;0
26/12/2019;04:00;4;1;3;Leicht bewölkt;1;0;0
26/12/2019;05:00;12;7;5;Bewölkt;1;0;0
26/12/2019;06:00;20;10;10;Bewölkt;1;0;0
26/12/2019;07:00;19;16;3;Bewölkt;1;0;0
26/12/2019;08:00;32;14;18;Leicht bewölkt;2;1;0
26/12/2019;09:00;55;38;17;Leicht bewölkt;2;2;0
26/12/2019;10:00;60;34;26;Leicht bewölkt;3;3;0
26/12/2019;11:00;103;50;53;Leicht bewölkt;4;3;0
26/12/2019;12:00;85;42;43;Leicht bewölkt;4;4;0
26/12/2019;13:00;106;55;51;Leicht bewölkt;4;4;0
26/12/2019;14:00;109;38;71;Bedeckt;4;4;0
26/12/2019;15:00;122;55;67;Bedeckt;4;4;0
26/12/2019;16:00;168;118;50;Bedeckt;4;3;0
26/12/2019;17:00;86;43;43;Bedeckt;3;2;0
26/12/2019;18:00;120;47;73;Bedeckt;3;2;0
26/12/2019;19:00;76;38;38;Bedeckt;2;1;0
26/12/2019;20:00;78;27;51;Stellenweiser Regenfall;2;1;0
26/12/2019;21:00;58;23;35;Stellenweiser Regenfall;1;1;0
26/12/2019;22:00;58;30;28;Stellenweiser Regenfall;2;1;0
26/12/2019;23:00;40;9;31;Nieselregen;2;1;0
27/12/2019;00:00;31;8;23;Nieselregen;3;1;0
27/12/2019;01:00;23;9;14;Nieselregen;3;1;0
27/12/2019;02:00;13;7;6;Leichter Regenfall;3;1;0
27/12/2019;03:00;9;6;3;Leichter Regenfall;4;1;0
27/12/2019;04:00;13;5;8;Leichter Regenfall;4;1;0
27/12/2019;05:00;14;11;3;Leichter Regenfall;4;1;0
27/12/2019;06:00;60;38;22;Leichter Regenfall;4;2;0
27/12/2019;07:00;78;51;27;Leichter Regenfall;4;2;0
27/12/2019;08:00;117;82;35;Mäßiger Regenfall;4;2;0
27/12/2019;09:00;103;75;28;Mäßiger Regenfall;5;2;0
27/12/2019;10:00;155;100;55;Mäßiger Regenfall;5;3;0
27/12/2019;11:00;209;115;94;Mäßiger Regenfall;5;3;0
27/12/2019;12:00;260;131;129;Mäßiger Regenfall;5;4;1
27/12/2019;13:00;261;135;126;Mäßiger Regenfall;5;4;0
27/12/2019;14:00;276;153;123;Mäßiger Regenfall;5;5;0
27/12/2019;15:00;254;133;121;Mäßiger Regenfall;6;5;0
27/12/2019;16:00;273;119;154;Mäßiger Regenfall;5;5;0
27/12/2019;17:00;233;109;124;Leichter Regenfall;5;4;0
27/12/2019;18:00;180;73;107;Leichter Regenfall;4;3;0
27/12/2019;19:00;138;69;69;Leichter Regenfall;4;3;0
27/12/2019;20:00;128;64;64;Leichter Regenfall;4;2;0
27/12/2019;21:00;79;33;46;Leichter Regenfall;4;2;0
27/12/2019;22:00;56;15;41;Leichter Regenfall;3;1;0
27/12/2019;23:00;71;22;49;Nieselregen;3;1;0
28/12/2019;00:00;42;15;27;Nieselregen;3;0;0
28/12/2019;01:00;44;10;34;Nieselregen;3;0;0
28/12/2019;02:00;20;4;16;Nieselregen;3;0;0
28/12/2019;03:00;16;4;12;Nieselregen;3;0;0
28/12/2019;04:00;8;5;3;Nieselregen;2;0;0
28/12/2019;05:00;25;15;10;Leicht bewölkt;2;-1;0
28/12/2019;06:00;32;22;10;Leicht bewölkt;2;-1;0
28/12/2019;07:00;36;21;15;Leicht bewölkt;2;-1;0
28/12/2019;08:00;84;52;32;Leicht bewölkt;2;-1;0
28/12/2019;09:00;153;113;40;Leicht bewölkt;2;-1;0
28/12/2019;10:00;211;125;86;Leicht bewölkt;2;0;0
28/12/2019;11:00;251;145;106;Leicht bewölkt;3;1;0
28/12/2019;12:00;278;144;134;Leicht bewölkt;4;1;0
28/12/2019;13:00;321;183;138;Leicht bewölkt;4;1;0
28/12/2019;14:00;273;132;141;Leicht bewölkt;4;1;0
28/12/2019;15:00;287;134;153;Leicht bewölkt;3;0;0
28/12/2019;16:00;232;95;137;Leicht bewölkt;3;-1;0
28/12/2019;17:00;249;97;152;Leicht bewölkt;2;-1;0
28/12/2019;18:00;183;77;106;Leicht bewölkt;1;-2;0
28/12/2019;19:00;168;91;77;Leicht bewölkt;1;-3;0
28/12/2019;20:00;134;59;75;Leicht bewölkt;0;-3;0
28/12/2019;21:00;82;42;40;Leicht bewölkt;0;-3;0
28/12/2019;22:00;81;34;47;Leicht bewölkt;-1;-3;0
28/12/2019;23:00;70;24;46;Leicht bewölkt;-1;-3;0
29/12/2019;00:00;73;21;52;Leicht bewölkt;-1;-3;0
29/12/2019;01:00;39;10;29;Leicht bewölkt;-1;-3;0
29/12/2019;02:00;30;12;18;Leicht bewölkt;-1;-3;0
29/12/2019;03:00;22;2;20;Leicht bewölkt;-1;-3;0
29/12/2019;04:00;10;5;5;Leicht bewölkt;-1;-3;0
29/12/2019;05:00;10;3;7;Leicht bewölkt;-1;-4;0
29/12/2019;06:00;14;9;5;Leicht bewölkt;-1;-4;0
29/12/2019;07:00;18;15;3;Leicht bewölkt;-1;-3;0
29/12/2019;08:00;33;22;11;Leicht bewölkt;-1;-3;0
29/12/2019;09:00;61;31;30;Leicht bewölkt;0;-3;0
29/12/2019;10:00;83;40;43;Leicht bewölkt;1;-1;0
29/12/2019;11:00;114;59;55;Leicht bewölkt;2;0;0
29/12/2019;12:00;128;64;64;Leicht bewölkt;3;1;0
29/12/2019;13:00;183;107;76;Leicht bewölkt;3;1;0
29/12/2019;14:00;198;97;101;Leicht bewölkt;3;1;0
29/12/2019;15:00;171;74;97;Leicht bewölkt;3;1;0
29/12/2019;16:00;187;94;93;Leicht bewölkt;2;-1;0
29/12/2019;17:00;207;99;108;Leicht bewölkt;1;-2;0
29/12/2019;18:00;144;68;76;Leicht bewölkt;0;-3;0
29/12/2019;19:00;92;41;51;Leicht bewölkt;-1;-3;0
29/12/2019;20:00;85;32;53;Leicht bewölkt;-1;-4;0
29/12/2019;21:00;98;29;69;Leicht bewölkt;-2;-4;0
29/12/2019;22:00;59;29;30;Leicht bewölkt;-2;-4;0
29/12/2019;23:00;59;29;30;Leicht bewölkt;-2;-4;0
30/12/2019;00:00;26;10;16;Leicht bewölkt;-2;-5;0
30/12/2019;01:00;26;7;19;Leicht bewölkt;-2;-4;0
30/12/2019;02:00;8;5;3;Leicht bewölkt;-2;-4;0
30/12/2019;03:00;4;1;3;Leicht bewölkt;-2;-4;0
30/12/2019;04:00;9;2;7;Leicht bewölkt;-2;-4;0
30/12/2019;05:00;20;14;6;Leicht bewölkt;-2;-4;0
30/12/2019;06:00;57;36;21;Leicht bewölkt;-2;-4;0
30/12/2019;07:00;117;62;55;Leicht bewölkt;-2;-3;0
30/12/2019;08:00;138;84;54;Leicht bewölkt;-1;-2;0
30/12/2019;09:00;175;113;62;Leicht bewölkt;-1;-2;0
30/12/2019;10:00;237;124;113;Leicht bewölkt;1;0;0
30/12/2019;11:00;289;173;116;Leicht bewölkt;2;1;0
30/12/2019;12:00;276;134;142;Leicht bewölkt;4;3;0
30/12/2019;13:00;336;167;169;Leicht bewölkt;3;3;0
30/12/2019;14:00;365;185;180;Leicht bewölkt;3;3;0
30/12/2019;15:00;336;158;178;Leicht bewölkt;3;3;0
30/12/2019;16:00;358;167;191;Leicht bewölkt;2;2;0
30/12/2019;17:00;287;121;166;Leicht bewölkt;1;1;0
30/12/2019;18:00;249;113;136;Leicht bewölkt;0;0;0
30/12/2019;19:00;208;73;135;Leicht bewölkt;0;0;0
30/12/2019;20:00;149;55;94;Leicht bewölkt;0;0;0
30/12/2019;21:00;85;35;50;Leicht bewölkt;0;0;0
30/12/2019;22:00;70;30;40;Leicht bewölkt;0;-1;0
30/12/2019;23:00;48;11;37;Leicht bewölkt;0;-1;0
31/12/2019;00:00;45;26;19;Leicht bewölkt;0;-1;0
31/12/2019;01:00;45;22;23;Leicht bewölkt;0;-1;0
31/12/2019;02:00;8;5;3;Leicht bewölkt;0;0;0
31/12/2019;03:00;4;1;3;Leicht bewölkt;1;0;0
31/12/2019;04:00;9;7;2;Leicht bewölkt;0;0;0
31/12/2019;05:00;24;15;9;Leicht bewölkt;0;0;0
31/12/2019;06:00;30;16;14;Leicht bewölkt;0;0;0
31/12/2019;07:00;71;45;26;Leicht bewölkt;1;1;0
31/12/2019;08:00;112;70;42;Leicht bewölkt;2;2;0
31/12/2019;09:00;173;114;59;Leicht bewölkt;3;3;0
31/12/2019;10:00;281;177;104;Leicht bewölkt;4;4;0
31/12/2019;11:00;283;136;147;Sonnig;5;5;0
31/12/2019;12:00;268;109;159;Sonnig;6;6;0
31/12/2019;13:00;263;112;151;Sonnig;5;5;0
31/12/2019;14:00;248;83;165;Leicht bewölkt;5;5;0
31/12/2019;15:00;167;73;94;Leicht bewölkt;4;4;0
31/12/2019;16:00;160;85;75;Leicht bewölkt;3;3;0
31/12/2019;17:00;187;98;89;Leicht bewölkt;3;2;0
31/12/2019;18:00;218;119;99;Leicht bewölkt;2;1;0
31/12/2019;19:00;211;93;118;Leicht bewölkt;2;0;0
31/12/2019;20:00;96;61;35;Leicht bewölkt;1;0;0
31/12/2019;21:00;74;33;41;Leicht bewölkt;1;-1;0
31/12/2019;22:00;61;34;27;Leicht bewölkt;1;-1;0
31/12/2019;23:00;133;103;30;Leicht bewölkt;1;-1;0
